cues	outcomes
RES_RLA_ESC_SCO_#RE_COR_ORL_LA#	RESCORLA
RES_A#W_RLA_WAG_ESC_SCO_NER_#RE_COR_ER#_#WA_AGN_GNE_ORL_LA#	RESCORLA_WAGNER
#MO_ESC_SCO_R#M_ODE_NER_ELL_COR_MOD_GNE_ORL_LA#_RES_ER#_#WA_AGN_A#W_WAG_DEL_#RE_LL#_RLA	RESCORLA_WAGNER_MODELL
BEV_#MO_#BE_ET#_R#M_EVE_ODE_NER_ELL_MOD_GNE_EZE_L#B_ER#_AGN_#WA_VEZ_ZET_WAG_DEL_LL#	WAGNER_MODELL_BEVEZET
BEV_#MO_#BE_ET#_EVE_ODE_ESZ_ELL_SZE_T#S_MOD_RKE_EZE_#SZ_KES_SZT_L#B_ERK_ZET_VEZ_DEL_ZER_ZT#_LL#	MODELL_BEVEZET_SZERKESZT
#SZ_ESZ_BEV_EVE_KES_SZT_SZE_T#S_ERK_ZER_#SE_SE#_ZT#_#BE_ZET_ET#_VEZ_RKE_EZE	BEVEZET_SZERKESZT_SE
#SZ_ESZ_KES_SZT_SZE_T#S_ERK_ZER_#SE_SE#_ZT#_RKE_#A#_E#A	SZERKESZT_SE_A
A#W_kip_#SE_SE#_ip#_#A#_E#A_#Wi_iki_Wik	SE_A_Wikip
A#W_p#d_#di_kip_di#_ip#_#Wi_#A#_iki_Wik	A_Wikip_di
p#d_#di_kip_di#_#Wi_ip#_#b#_iki_i#b_Wik	Wikip_di_b
#di_di#_b#l_#b#_i#b_#l#	di_b_l
l#a_#a#_b#l_#b#_#l#	b_l_a
l#a_#sz_bad_sza_#a#_ad#_zab_aba_a#s_#l#	l_a_szabad
cik_lop_enc_#en_#sz_bad_sza_#a#_ad#_zab_aba_d#e_nci_a#s_ikl_klo_op#	a_szabad_enciklop
lop_enc_p#d_#en_bad_#sz_sza_#di_di#_ad#_d#e_aba_zab_nci_cik_ikl_klo_op#	szabad_enciklop_di
lop_enc_p#d_#en_i#b_#b#_#di_di#_nci_cik_ikl_klo_op#	enciklop_di_b
#di_di#_b#l_#b#_i#b_#l#	di_b_l
#Ug_gr#_l#U_b#l_Ugr_#b#_#l#	b_l_Ugr
#Ug_gr#_#s#_l#U_Ugr_r#s_#l#	l_Ugr_s
#Ug_avi_gr#_vig_nav_ig#_#s#_s#n_r#s_Ugr_#na	Ugr_s_navig
avi_nav_ig#_#s#_s#n_#ci_ci#_g#c_vig_#na	s_navig_ci
avi_res_#ke_ker_es#_nav_ig#_ci#_#ci_i#k_g#c_vig_ere_#na	navig_ci_keres
res_ker_#ke_es#_s#s_#s#_ci#_i#k_#ci_ere	ci_keres_s
res_ker_#ke_es#_s#s_#s#_s#A_#A#_ere	keres_s_A
RES_RLA_ESC_SCO_#RE_COR_#s#_#A#_s#A_A#R_ORL_LA#	s_A_RESCORLA
RES_A#W_RLA_WAG_ESC_SCO_NER_#RE_COR_ER#_#WA_#A#_AGN_GNE_A#R_ORL_LA#	A_RESCORLA_WAGNER
#MO_ESC_SCO_R#M_ODE_NER_ELL_COR_MOD_GNE_ORL_LA#_RES_ER#_#WA_AGN_A#W_WAG_DEL_#RE_LL#_RLA	RESCORLA_WAGNER_MODELL
R#M_WAG_#MO_DEL_NER_ELL_MOD_#a#_ER#_AGN_GNE_#WA_LL#_L#a_ODE	WAGNER_MODELL_a
a#k_#MO_ssz_DEL_las_zik_ass_ELL_kus_kla_MOD_#a#_szi_iku_LL#_L#a_ODE_us#_#kl	MODELL_a_klasszikus
zik_ond_kla_iku_kus_#ko_szi_dic_ndi_#kl_cio_a#k_las_ass_s#k_#a#_kon_ssz_ici_on#_us#_ion	a_klasszikus_kondicion
zik_ond_kla_iku_#l#_kus_#ko_szi_n#l_dic_ndi_#kl_cio_las_ass_s#k_kon_ssz_ici_on#_us#_ion	klasszikus_kondicion_l
cio_n#l_ond_ici_l#s_#ko_#s#_on#_kon_dic_ndi_#l#_ion	kondicion_l_s
#eg_l#s_egy_gy#_#s#_s#e_#l#	l_s_egy
y#m_#eg_ode_lje_egy_je#_#mo_llj_gy#_del_#s#_mod_s#e_ell	s_egy_modellje
y#m_#mo_del_#eg_egy_je#_ely_ame_mel_mod_lyb_#am_ell_ben_ode_gy#_lje_llj_e#a_ybe_en#	egy_modellje_amelyben
ben_az#_ode_n#a_lje_ybe_je#_#mo_llj_ely_del_e#a_ame_mel_lyb_en#_mod_#am_#az_ell	modellje_amelyben_az
ben_lat_n#a_#ll_ybe_ot#_ely_az#_ame_mel_tot_lla_#am_lyb_#az_z#l_ato_en#	amelyben_az_llatot
rra_lat_ra#_#ll_ot#_arr_az#_t#a_#ar_tot_lla_z#l_#az_ato	az_llatot_arra
tan_rra_lat_ra#_#ll_a#t_ot#_arr_t#a_#ar_tot_lla_#ta_an#_ato	llatot_arra_tan
tan_rra_#tj_ra#_a#t_arr_tj#_#ar_n#t_an#_#ta	arra_tan_tj
tan_#tj_#k#_tj#_n#t_an#_#ta_j#k	tan_tj_k
#k#_k#h_#tj_ogy_hog_tj#_gy#_j#k_#ho	tj_k_hogy
k#h_#k#_y#k_ogy_gy#_hog_#ho	k_hogy_k
#k#_k#l_y#k_ogy_gy#_hog_#ho_#l#	hogy_k_l
bs#_nbs_#k#_k#l_l#n_#l#_#nb	k_l_nbs
bs#_nbs_#ge_get_et#_l#n_s#g_#l#_#nb	l_nbs_get
jon_bs#_nbs_#tu_#ge_tud_djo_udj_get_et#_on#_s#g_t#t_#nb	nbs_get_tudjon
jon_#tu_ni#_#ge_#te_tud_djo_udj_nni_n#t_get_et#_on#_ten_t#t_enn	get_tudjon_tenni
jon_#ak_#tu_i#a_ni#_#te_tud_djo_udj_nni_n#t_ak#_on#_ten_enn	tudjon_tenni_ak
#ak_k#z_i#a_ni#_#te_nni_ak#_#z#_ten_enn	tenni_ak_z
#tt_#ak_k#z_ak#_z#t_#z#_tt#	ak_z_tt
mi#_#tt_ami_t#a_z#t_#am_#z#_tt#	z_tt_ami
mi#_#tt_#v#_ami_i#v_t#a_#am_tt#	tt_ami_v
mi#_#rh_#v#_rha_ami_i#v_v#r_#am_hat_at#	ami_v_rhat
#rh_#v#_rha_v#r_#an_t#a_an#_hat_at#	v_rhat_an
#rh_rha_#t#_#an_t#a_n#t_an#_hat_at#	rhat_an_t
#t#_#an_#rt_t#r_n#t_an#_rt#	an_t_rt
t#n_#t#_#nn_ni#_nni_#rt_t#r_rt#	t_rt_nni
#fo_t#n_fog_#nn_ni#_nni_#rt_rt#_i#f_og#	rt_nni_fog
#fo_fog_#nn_g#s_ni#_nni_#s#_i#f_og#	nni_fog_s
mi#_#fo_ami_s#a_fog_g#s_#s#_#am_og#	fog_s_ami
mi#_val_ami_s#a_i#v_#va_#s#_#am_al#	s_ami_val
mi#_val_ami_i#v_#va_#j#_#am_al#_l#j	ami_val_j
val_j#b_#va_#j#_ban_#ba_an#_al#_l#j	val_j_ban
#t#_j#b_#j#_ban_n#t_an#_#ba	j_ban_t
#t#_ban_t#r_n#t_#rt_an#_#ba_rt#	ban_t_rt
t#n_#t#_ik#_#rt_t#r_#ni_rt#_nik	t_rt_nik
#Ez_t#n_Ez#_ik#_k#E_#rt_#ni_rt#_nik	rt_nik_Ez
#Ez_#eg_Ez#_egy_ik#_z#e_gy#_k#E_#ni_nik	nik_Ez_egy
#eg_#Ez_#k#_Ez#_y#k_egy_z#e_gy#	Ez_egy_k
#eg_#k#_y#k_egy_gy#_#s#_k#s	egy_k_s
ti#_#k#_rle_eti_#s#_let_k#s_#rl_s#r	k_s_rleti
ti#_ode_rle_eti_i#m_#mo_ll#_del_#s#_let_#rl_mod_s#r_ell	s_rleti_modell
#mo_del_let_ely_ame_mel_mod_#am_lyb_ell_ti#_l#a_ben_ode_eti_rle_i#m_ll#_#rl_ybe_en#	rleti_modell_amelyben
n#m_ind_#mo_del_min_ely_ame_mel_mod_lyb_#am_ell_l#a_ben_ode_nde_den_#mi_ll#_ybe_en#	modell_amelyben_minden
#mi_ben_#eg_es#_n#m_ind_ybe_n#e_egy_min_ely_nde_den_ame_mel_gye_#am_lyb_yes_en#	amelyben_minden_egyes
#mi_#eg_es#_s#i_ind_egy_n#e_nge_nde_min_gye_ger_ing_er#_den_yes_#in_en#	minden_egyes_inger
#eg_es#_s#i_egy_nge_ger_gye_er#_#va_vag_ing_agy_gy#_yes_#in_r#v	egyes_inger_vagy
jel_#je_ger_nge_er#_#va_vag_agy_ing_gy#_y#j_en#_len_#in_ele_r#v	inger_vagy_jelen
jel_#je_n#v_#va_vag_y#j_gy#_en#_an#_len_van_ele_agy	vagy_jelen_van
jel_#je_n#v_#va_vag_agy_gy#_an#_len_van_ele_en#	jelen_van_vagy
n#v_nin_vag_#va_inc_gy#_#ni_an#_ncs_van_cs#_y#n_agy	van_vagy_nincs
jel_s#j_#je_nin_#va_vag_inc_gy#_ele_#ni_en#_len_ncs_cs#_y#n_agy	vagy_nincs_jelen
jel_s#j_#eg_#je_egy_n#e_inc_gy#_#ni_en#_len_ncs_cs#_ele_nin	nincs_jelen_egy
jel_y#m_gha_#eg_egh_#je_egy_n#e_at#_gy#_len_hat_meg_#me_ele_en#	jelen_egy_meghat
y#m_gha_tt#_#eg_egh_ott_ozo_egy_at#_gy#_zot_t#r_roz_hat_meg_#me_#ro	egy_meghat_rozott
tba_t#p_ill_roz_#me_ott_at#_gha_ozo_pil_t#r_lla_an#_ana_atb_meg_egh_#pi_zot_#ro_ban_lan_hat_tt#_nat	meghat_rozott_pillanatban
tt#_ott_tba_ozo_t#p_#pi_ill_atb_n#a_zot_pil_ban_lan_#a#_lla_roz_ana_an#_#ro_nat	rozott_pillanatban_a
a#p_tba_ill_atb_#pi_n#a_pr#_pil_ban_#a#_lan_lla_an#_ana_#pr_nat	pillanatban_a_pr
a#p_r#b_pr#_#a#_#b#_#pr	a_pr_b
b#b_r#b_pr#_ban_#ba_an#_#b#_#pr	pr_b_ban
b#b_#Az_Az#_ban_#ba_an#_n#A_#b#	b_ban_Az
#Az_Az#_el#_z#e_ban_#el_an#_#ba_n#A	ban_Az_el
l#r_jel_Az#_#Az_el#_eje_lz#_z#e_elz_#el_rej_#re	Az_el_rejelz
l#r_jel_#se_el#_eje_lz#_elz_#el_rej_se#_z#s_#re	el_rejelz_se
jel_#se_eje_lz#_elz_e#a_#a#_rej_se#_z#s_#re	rejelz_se_a
#se_a#f_fel_e#a_#a#_lt#_se#_#fe_elt	se_a_felt
a#f_tle_#tl_fel_#a#_lt#_len_#fe_elt_t#t_en#	a_felt_tlen
ern_tle_ek#_nge_#tl_ger_fel_#in_rne_ing_lt#_nek_len_#fe_elt_t#t_en#_n#i	felt_tlen_ingernek
ern_tle_ek#_nge_#tl_ger_rne_#a#_ing_k#a_nek_len_#in_en#_n#i	tlen_ingernek_a
ern_a#k_#k#_ek#_ger_nge_rne_#a#_ing_k#a_nek_#in	ingernek_a_k
a#k_#k#_#s#_#a#_k#s	a_k_s
ben_#k#_rle_#s#_let_k#s_tbe_#rl_s#r_en#_etb	k_s_rletben
ben_hat_uta_emu_n#b_rle_mut_ath_at#_#s#_let_tbe_#rl_tat_s#r_#be_bem_tha_en#_etb	s_rletben_bemutathat
uta_let_nt#_t#m_min_tat_at#_tha_etb_ben_rle_int_mut_tbe_#be_#mi_n#b_ath_#rl_hat_emu_en#_bem	rletben_bemutathat_mint
#mi_hat_uta_emu_#az_int_mut_at#_min_az#_t#a_nt#_tat_ath_t#m_#be_tha_bem	bemutathat_mint_az
#mi_oci_zoc_ssz_ass_cia_int_iat_min_az#_t#a_nt#_#as_z#a_#az_at#_szo	mint_az_asszociat
oci_zoc_ssz_#v#_ass_cia_iat_az#_#as_z#a_#az_at#_t#v_szo	az_asszociat_v
oci_zoc_ssz_#v#_#er_v#e_ass_cia_iat_er#_#as_at#_t#v_szo	asszociat_v_er
#v#_#er_v#e_#ss_er#_r#s_ss#	v_er_ss
#er_#ss_er#_r#s_ss#_s#g_#g#	er_ss_g
ssz_zes_#ss_g#s_sze_ss#_s#g_#g#_ess	ss_g_sszess
ssz_zes_g#s_#ss_#ge_sze_ge#_ss#_s#g_#g#_ess	g_sszess_ge
ssz_zes_#ss_#ge_sze_e#a_#a#_ge#_ss#_s#g_ess	sszess_ge_a
a#k_#k#_#ge_e#a_#a#_ge#	ge_a_k
a#k_#k#_#s#_#a#_k#s	a_k_s
ben_#k#_rle_#s#_let_k#s_tbe_#rl_s#r_en#_etb	k_s_rletben
jel_ben_#je_enl_rle_ev#_n#j_nle_#s#_let_tbe_#rl_len_s#r_lev_ele_en#_etb	s_rletben_jelenlev
jel_ond_ev#_n#j_let_ele_#je_enl_ion_nle_#ko_dic_ndi_etb_cio_ben_rle_tbe_kon_lev_v#k_ici_on#_#rl_len_en#	rletben_jelenlev_kondicion
jel_ond_ev#_lt#_ele_#je_enl_nle_#ko_n#l_dic_ndi_cio_len_#lt_kon_lev_v#k_ici_on#_ion	jelenlev_kondicion_lt
rek_ond_t#i_nge_ing_lt#_#in_#ko_ekn_kne_nek_n#l_dic_ere_ndi_cio_ek#_kon_#lt_ici_ger_on#_ion	kondicion_lt_ingereknek
#Ez_Ez#_rek_t#i_ek#_nge_ger_k#E_ing_ekn_lt#_kne_nek_#lt_ere_#in	lt_ingereknek_Ez
#Ez_Ez#_rek_ek#_ger_nge_k#E_#a#_ing_ekn_kne_nek_z#a_ere_#in	ingereknek_Ez_a
jel_#Ez_leg_tes_Ez#_#je_zet_gze_egz_lle_ess_#a#_z#a_ss#_a#j_ell_ete	Ez_a_jellegzetess
jel_leg_tes_zet_#je_gze_egz_s#g_#ge_lle_ess_#a#_ge#_ss#_a#j_ell_ete	a_jellegzetess_ge
jel_leg_tes_zet_#je_gze_s#g_#ge_lle_ess_e#a_#a#_ge#_ss#_egz_ell_ete	jellegzetess_ge_a
ode_ek#_#ge_a#m_#mo_e#a_#a#_del_lne_lln_mod_nek_ge#_ell	ge_a_modellnek
uta_#mo_del_a#m_lln_mod_nek_tat_k#b_ja#_ell_ode_atj_ek#_mut_tja_#a#_#be_lne_emu_bem	a_modellnek_bemutatja
uta_#mo_a#a_del_lln_mod_nek_tat_k#b_ja#_ell_ode_atj_ek#_mut_tja_#a#_#be_lne_emu_bem	modellnek_bemutatja_a
uta_emu_atj_#na_nag_mut_tja_a#a_gy#_#a#_tat_a#n_#be_ja#_agy_bem	bemutatja_a_nagy
jel_nag_#je_ent_gy#_y#j_#a#_nt#_len_a#n_ele_agy_#na	a_nagy_jelent
jel_nag_#je_ent_y#j_gy#_#s#_nt#_t#s_len_ele_agy_#na	nagy_jelent_s
jel_#je_s#g_ent_#s#_nt#_t#s_len_ele_#g#	jelent_s_g
el#_#s#_#el_g#e_s#g_#g#	s_g_el
l#r_hal_ala_el#_eha_ad#_#el_g#e_reh_#re_#g#_lad	g_el_rehalad
l#r_hal_ala_el#_eha_#st_ad#_#el_d#s_reh_#re_st#_lad	el_rehalad_st
hal_ala_eha_#st_t#a_ad#_d#s_#a#_reh_#re_st#_lad	rehalad_st_a
or#_a#k_#ko_t#a_#a#_kor_#st_st#	st_a_kor
or#_bbi_a#k_bi#_r#b_#ko_#a#_kor_#bb	a_kor_bbi
or#_bbi_ode_hez_bi#_ekh_r#b_i#m_#ko_#mo_kor_del_lle_khe_ez#_mod_lek_#bb_ell	kor_bbi_modellekhez
#mo_del_#bb_bbi_isz_vis_#vi_hez_bi#_khe_ony_mod_ell_ode_zon_lek_szo_z#v_ekh_i#m_lle_ny#_ez#	bbi_modellekhez_viszony
#mo_del_y#t_isz_vis_#vi_hez_khe_ony_mod_ell_va#_ode_zon_lek_szo_tva_z#v_ekh_lle_ny#_ez#_#tv	modellekhez_viszony_tva
isz_va#_vis_tva_#vi_a#s_zon_ny#_#s#_ony_#tv_y#t_szo	viszony_tva_s
#le_va#_tva_s#l_a#s_leh_ehe_#s#_et#_#tv_het	tva_s_lehet
#le_#v#_s#l_leh_ehe_#s#_et#_het_t#v	s_lehet_v
#le_tte_#v#_ett_tet_leh_v#t_#te_ehe_et#_te#_het_t#v	lehet_v_tette
tte_#v#_ett_tet_v#t_#te_e#a_#a#_te#	v_tette_a
tos_tte_#fo_ett_tet_nto_a#f_os#_#te_e#a_#a#_te#_ont_fon	tette_a_fontos
tos_#fo_#k#_nto_a#f_os#_s#k_#a#_ont_fon	a_fontos_k
tos_#fo_#k#_nto_os#_s#k_#s#_k#s_ont_fon	fontos_k_s
ti#_#k#_rle_eti_#s#_let_k#s_#rl_s#r	k_s_rleti
jel_ens_ti#_i#j_#je_rle_eti_ns#_#s#_let_#rl_len_s#r_ele	s_rleti_jelens
jel_ens_ti#_i#j_#je_eti_rle_ns#_s#g_#ge_ek#_gek_let_#rl_len_ele	rleti_jelens_gek
jel_k#e_#eg_#je_ns#_gys_ek#_s#g_#ge_egy_er#_gek_sze_ele_zer_ysz_len_ens	jelens_gek_egyszer
mag_#eg_k#e_gya_r#m_gys_ek#_#ge_egy_er#_ar#_sze_zer_ysz_yar_gek_#ma_agy	gek_egyszer_magyar
mag_#eg_gya_r#m_gys_zat_egy_er#_r#z_ar#_sze_#za_zer_ysz_yar_at#_#ma_agy	egyszer_magyar_zat
mag_gya_zat_#t#_r#z_ar#_#za_yar_t#t_at#_#ma_agy	magyar_zat_t
#mi_#t#_int_#za_min_nt#_t#t_at#_t#m_zat	zat_t_mint
#mi_#t#_int_min_t#a_#a#_nt#_t#m	t_mint_a
#mi_ol#_blo_lok_kol_a#b_int_min_#bl_t#a_#a#_nt#_okk_kko	mint_a_blokkol
ol#_blo_lok_kol_l#s_a#b_#bl_#a#_#s#_okk_kko	a_blokkol_s
ol#_blo_lok_kol_l#s_#bl_#s#_#Eb_okk_Ebb_bb#_s#E_kko	blokkol_s_Ebb
#s#_Ebb_#Eb_b#l_bb#_s#E_#l#	s_Ebb_l
l#k_#ki_kif_#Eb_Ebb_ly#_b#l_fol_bb#_ifo_oly_#l#	Ebb_l_kifoly
#la_lag_l#k_#ki_kif_ly#_fol_ifo_oly_#l#_y#l_ag#	l_kifoly_lag
#la_lag_g#a_#ki_kif_#a#_ly#_fol_ifo_oly_y#l_ag#	kifoly_lag_a
#la_lag_orl_g#a_sco_a#R_esc_la#_#a#_Res_#Re_rla_cor_ag#	lag_a_Rescorla
orl_a#W_a#R_esc_Wag_agn_ner_er#_la#_#a#_Res_#Re_rla_cor_gne_#Wa_sco	a_Rescorla_Wagner
ner_Wag_#mo_del_rla_sco_orl_esc_er#_mod_cor_ell_a#W_ode_agn_la#_r#m_ll#_Res_#Re_gne_#Wa	Rescorla_Wagner_modell
#le_tt#_ett_r#m_ode_agn_Wag_ner_er#_#mo_ll#_del_l#l_let_mod_gne_#Wa_ell	Wagner_modell_lett
#le_ett_ode_#mo_ll#_del_l#l_let_t#a_az#_mod_#az_tt#_ell	modell_lett_az
#le_#eg_ett_egy_ik#_z#e_yik_az#_t#a_let_#az_gyi_tt#	lett_az_egyik
#le_oly_#eg_leg_k#l_egy_ik#_z#e_yik_az#_efo_ly#_bef_fol_#az_egb_gyi_gbe	az_egyik_legbefoly
y#s_ik#_sos_oly_gyi_#eg_k#l_egy_bb#_gbe_leg_yik_abb_ly#_fol_egb_sab_#le_#so_efo_bef_osa	egyik_legbefoly_sosabb
y#s_#mo_sos_del_oly_mod_bb#_gbe_ell_leg_ode_b#m_abb_ly#_fol_egb_sab_#le_#so_efo_ll#_bef_osa	legbefoly_sosabb_modell
l#a_#so_b#m_ode_#mo_ll#_sos_del_#a#_abb_mod_bb#_sab_ell_osa	sosabb_modell_a
l#a_tan_anu_ode_nul_a#t_#mo_ul#_ll#_del_#a#_mod_#ta_ell	modell_a_tanul
anu_tan_nul_sn#_l#s_a#t_ul#_#sn_#a#_#ta	a_tanul_sn
anu_tan_nul_sn#_l#s_ul#_#sn_#ta_n#l_#l#	tanul_sn_l
sn#_ab#_#ha_#sn_hab_n#l_l#h_#l#	sn_l_hab
b#r_#r#_ab#_#ha_hab_l#h_#l#	l_hab_r
akr_gya_ran_yak_#r#_ab#_#ha_an#_hab_r#g_b#r_#gy_kra	hab_r_gyakran
gya_ran_yak_#r#_n#b_an#_r#g_#b#_akr_#gy_kra	r_gyakran_b
gya_ran_yak_n#b_b#r_#r#_an#_#b#_akr_#gy_kra	gyakran_b_r
#r#_r#l_lt#_#b#_b#r_#lt	b_r_lt
#k#_#r#_lt#_r#l_#lt_t#k	r_lt_k
jel_#k#_egj_gje_en#_lt#_len_#lt_meg_#me_ele_t#k_k#m	lt_k_megjelen
jel_#k#_egj_gje_#se_n#s_se#_len_meg_#me_ele_en#_k#m	k_megjelen_se
jel_gje_egj_#se_e#t_n#s_se#_len_#ta_ta#_meg_#me_ele_en#	megjelen_se_ta
#se_e#t_#ta_se#_#A#_ta#_a#A	se_ta_A
cor_orl_sco_esc_la#_Res_#Re_#A#_#ta_rla_A#R_ta#_a#A	ta_A_Rescorla
orl_a#W_agn_esc_Wag_ner_er#_la#_Res_#Re_#A#_cor_rla_A#R_gne_#Wa_sco	A_Rescorla_Wagner
ner_Wag_#mo_del_rla_sco_orl_esc_er#_mod_cor_ell_a#W_ode_agn_la#_r#m_ll#_Res_#Re_gne_#Wa	Rescorla_Wagner_modell
l#a_r#m_ode_agn_Wag_ner_er#_#mo_ll#_del_#a#_mod_gne_#Wa_ell	Wagner_modell_a
fig_l#a_lem_ode_a#f_#mo_gye_ll#_del_#a#_igy_yel_em#_mod_#fi_ele_ell	modell_a_figyelem
lem_m#k_#k#_a#f_gye_igy_#a#_em#_yel_#fi_ele_fig	a_figyelem_k
lem_m#k_#k#_k#z_gye_igy_em#_yel_#fi_#z#_ele_fig	figyelem_k_z
#k#_k#z_tj#_pon_ntj_ont_#z#_ppo_#pp_z#p	k_z_ppontj
j#b_tj#_pon_ntj_#ba_ba#_ont_#z#_ppo_#pp_z#p	z_ppontj_ba
a#k_#ke_ker_j#b_er#_tj#_pon_ntj_#ba_ba#_ont_ppo_#pp	ppontj_ba_ker
a#k_ker_#ke_er#_#ba_r#l_ba#_#lt_lt#	ba_ker_lt
ker_#ke_#az_er#_az#_t#a_r#l_lt#_#lt	ker_lt_az
lm#_elm_#az_z#e_az#_t#a_#el_lt#_#lt	lt_az_elm
lm#_elm_z#e_az#_#el_m#l_lt#_#az_#lt	az_elm_lt
lm#_elm_ben_vek_kbe_#ve_ekb_#el_m#l_lt#_#lt_t#v_en#	elm_lt_vekben
isz_ben_n#h_vek_kbe_#ve_ekb_sze_his_lt#_#hi_#lt_zen_t#v_en#	lt_vekben_hiszen
isz_ben_#sz_n#h_n#s_vek_kbe_#ve_ekb_sze_sz#_his_#hi_zen_en#	vekben_hiszen_sz
isz_#sz_n#s_os#_#mo_sze_sz#_en#_#hi_zen_mos_z#m_his	hiszen_sz_mos
lm#_tan_anu_nul_#sz_os#_#mo_sz#_#ta_ulm_mos_z#m_s#t	sz_mos_tanulm
lm#_tan_anu_nul_os#_#mo_ny#_#ta_ulm_m#n_#ny_mos_s#t	mos_tanulm_ny
lm#_anu_tan_nul_y#u_uta_tal_ny#_#ut_alt_ulm_#ta_lt#_m#n_#ny	tanulm_ny_utalt
y#u_rra_uta_ra#_tal_arr_ny#_t#a_#ar_#ut_alt_lt#_#ny	ny_utalt_arra
rra_uta_ra#_tal_ogy_arr_gy#_t#a_#ar_#ho_#ut_lt#_alt_hog_a#h	utalt_arra_hogy
rra_ra#_ogy_arr_gy#_#ho_#ar_#a#_hog_y#a_a#h	arra_hogy_a
#f#_a#f_ogy_gy#_#a#_hog_y#a_#ho	hogy_a_f
f#z_#f#_a#f_os#_#zi_sos_#a#_iso_zis	a_f_zisos
tev_f#z_#f#_ev#_os#_#te_#zi_sos_iso_zis_s#t	f_zisos_tev
tev_#ke_ev#_os#_ys#_#te_eny_#zi_sos_iso_nys_zis_ken_v#k_s#t	zisos_tev_kenys
tev_#ke_ev#_ys#_#ge_#te_eny_nys_ge#_ken_s#g_v#k	tev_kenys_ge
#ke_ys#_#ge_eny_e#a_#a#_nys_ge#_ken_s#g	kenys_ge_a
ami_a#d_opa_#ge_min_e#a_#a#_dop_#do_pam_ge#_in#	ge_a_dopamin
ami_a#d_opa_okn_nok_ak#_min_ono_pam_kna_uro_n#n_ron_eur_neu_#a#_dop_in#_nak_#ne_#do	a_dopamin_neuronoknak
ami_opa_okn_nok_ak#_min_ono_pam_k#a_kna_uro_n#n_ron_eur_neu_#a#_dop_in#_nak_#ne_#do	dopamin_neuronoknak_a
okn_nok_sos_ak#_#me_a#m_ost_iat_ono_k#a_al#_kna_uro_ron_tri_tal_eur_mes_neu_#a#_ata_nak_ria_str_eso_#ne	neuronoknak_a_mesostriatal
l#D_ria_tri_a#m_ost_str_iat_mes_eso_#a#_sos_ata_tal_al#_#DA_#me_DA#	a_mesostriatal_DA
l#D_el#_ria_tri_ost_str_iat_tal_mes_eso_sos_ata_A#e_#el_al#_#DA_#me_DA#	mesostriatal_DA_el
l#r_jel_el#_eje_lz#_elz_#el_A#e_rej_#DA_#re_DA#	DA_el_rejelz
l#r_jel_ben_#se_el#_eje_lz#_sek_kbe_elz_ekb_#el_rej_z#s_#re_en#	el_rejelz_sekben
jel_ben_#se_eje_n#a_lz#_sek_kbe_elz_ekb_#a#_rej_z#s_#re_en#	rejelz_sekben_a
a#k_ben_#se_#k#_n#a_sek_kbe_ekb_#a#_en#	sekben_a_k
a#k_#k#_k#z_#a#_#z#	a_k_z
yba_gyb_#k#_k#z_agy_#pa_pag_ban_an#_#z#_z#p	k_z_pagyban
z#p_gyb_yba_#k#_#pa_pag_ban_an#_n#k_#z#_agy	z_pagyban_k
yba_gyb_#k#_#pa_pag_ban_lja_#do_an#_n#k_olj_ja#_k#d_agy_dol	pagyban_k_dolja
#k#_a#a_#a#_#do_olj_ja#_k#d_lja_dol	k_dolja_a
ba#_a#a_hib_#a#_dol_iba_#do_olj_#hi_ja#_a#h_lja	dolja_a_hiba
#r#_ba#_hib_#a#_iba_a#r_#hi_a#h	a_hiba_r
#sz_#r#_szl_zle_it#_hib_#hi_iba_a#r_let_tei_r#s_ba#_eit_ete	hiba_r_szleteit
#sz_#r#_szl_zle_it#_t#a_let_#a#_tei_eit_r#s_ete	r_szleteit_a
llb_ben_#sz_ode_szl_a#m_zle_it#_#mo_lbe_t#a_let_#a#_tei_eit_del_mod_en#_ell_ete	szleteit_a_modellben
llb_ben_ode_a#m_#mo_lbe_del_#a#_en#_mod_n#A_#A#_ell	a_modellben_A
llb_cor_orl_ben_ode_esc_#mo_lbe_del_Res_en#_la#_#Re_mod_n#A_#A#_A#R_rla_ell_sco	modellben_A_Rescorla
orl_a#W_agn_esc_Wag_ner_er#_la#_Res_#Re_#A#_cor_rla_A#R_gne_#Wa_sco	A_Rescorla_Wagner
ner_Wag_#mo_lj#_del_rla_sco_orl_esc_er#_mod_cor_ell_a#W_ode_agn_la#_r#m_llj_Res_#Re_gne_#Wa	Rescorla_Wagner_modellj
r#m_ode_#t#_agn_Wag_ner_er#_#mo_llj_del_lj#_j#t_mod_gne_#Wa_ell	Wagner_modellj_t
ode_#t#_t#R_j#t_Rob_#Ro_#mo_llj_lj#_del_ber_ert_obe_mod_rt#_ell	modellj_t_Robert
#t#_t#R_ber_Rob_#Ro_ert_obe_rt#_#A#_t#A	t_Robert_A
cor_orl_ber_Rob_ert_#Ro_esc_la#_Res_#Re_obe_rt#_#A#_rla_A#R_t#A_sco	Robert_A_Rescorla
orl_ozt_zta_hoz_esc_la#_Res_#ho_#Re_#A#_cor_rla_A#R_a#h_ta#_sco	A_Rescorla_hozta
orl_ozt_zta_hoz_esc_a#l_la#_Res_#ho_#Re_rla_cor_a#h_#l#_ta#_sco	Rescorla_hozta_l
ozt_#tr_zta_hoz_tre_a#l_re#_l#t_#ho_#l#_ta#	hozta_l_tre
nns_nsy_#Pe_#tr_ylv_Pen_ani_e#P_re#_nia_syl_van_lva_ia#_l#t_enn_#l#_tre	l_tre_Pennsylvania
Egy_#Pe_#tr_Pen_e#P_gye_ia#_enn_tre_#Eg_yet_ylv_ani_re#_nia_lva_emr_ete_nns_nsy_mr#_syl_a#E_tem_van	tre_Pennsylvania_Egyetemr
Egy_#Pe_Pen_gye_ia#_#l#_enn_#Eg_r#l_yet_ylv_ani_nia_lva_emr_ete_nns_nsy_mr#_syl_a#E_tem_van	Pennsylvania_Egyetemr_l
Egy_yet_l#s_gye_mr#_#s#_#Eg_r#l_tem_emr_#l#_ete	Egyetemr_l_s
All_l#s_#s#_#Al_lan_lla_s#A_an#_#l#	l_s_Allan
All_n#R_#s#_#Al_lan_#R#_lla_s#A_an#	s_Allan_R
All_n#R_agn_Wag_ner_er#_#Al_lan_#R#_an#_lla_R#W_gne_#Wa	Allan_R_Wagner
ale_le#_r#Y_agn_Wag_ner_er#_Yal_#R#_R#W_gne_#Wa_#Ya	R_Wagner_Yale
ale_Egy_yet_r#Y_emr_agn_Wag_ner_er#_e#E_gye_mr#_Yal_#Eg_le#_tem_gne_#Wa_#Ya_ete	Wagner_Yale_Egyetemr
ale_Egy_yet_e#E_gye_mr#_Yal_#Eg_r#l_le#_tem_emr_#l#_#Ya_ete	Yale_Egyetemr_l
Egy_omj_gye_mje_#l#_art_jeg_egy_alo_#Ta_#Eg_r#l_yet_Tar_tal_lom_l#T_emr_ete_rta_yz#_mr#_gyz_tem	Egyetemr_l_Tartalomjegyz
rta_#k#_omj_art_Tar_tal_alo_#Ta_lom_jeg_egy_mje_gyz_yz#_l#T_z#k_#l#	l_Tartalomjegyz_k
omj_jt#_mje_art_jeg_egy_alo_#Ta_#el_elr_k#e_lre_Tar_tal_lom_rej_z#k_ejt_rta_#k#_yz#_gyz	Tartalomjegyz_k_elrejt
ejt_k#e_#k#_lre_jt#_#s#_#el_t#s_rej_elr	k_elrejt_s
ejt_ker_lre_s#S_er#_ike_jt#_#s#_#el_t#s_rej_elr_#Si_Sik	elrejt_s_Siker
ker_s#S_er#_ike_#s#_r#s_#Si_Sik	s_Siker_s
ker_s#a_er#_ike_#s#_#a#_r#s_#Si_Sik	Siker_s_a
s#a_#n#_#a#_#s#_a#n	s_a_n
#ps_#n#_psz_er#_sze_#a#_zer_a#n_n#p	a_n_pszer
#ps_#n#_psz_er#_sze_#s#_zer_r#s_n#p	n_pszer_s
#ps_psz_er#_sze_#s#_zer_r#s_s#g_#g#	pszer_s_g
#s#_#A#_g#A_s#g_#g#	s_g_A
ell_A#m_ode_#mo_ll#_del_#A#_mod_g#A_#g#	g_A_modell
apv_l#a_pve_ode_ala_vet_#mo_ll#_del_#al_mod_#A#_et#_A#m_lap_ell	A_modell_alapvet
apv_l#a_elt_pve_ode_ala_t#f_#mo_ll#_del_fel_#al_mod_lap_et#_lt#_#fe_vet_ell	modell_alapvet_felt
apv_elt_tel_pve_ala_t#f_#te_fel_ez#_#al_et#_lap_lt#_lez_#fe_vet_ele_t#t	alapvet_felt_telez
tel_#se_#te_fel_sei_ez#_ei#_lt#_lez_#fe_elt_ele_t#t_z#s	felt_telez_sei
Egy_tel_#se_i#E_enl_#te_gye_sei_nle_let_ez#_ei#_#Eg_yen_et#_z#s_lez_ele	telez_sei_Egyenlet
Egy_i#E_#se_enl_nle_gye_sei_let_#Eg_ei#_et#_t#A_#A#_yen	sei_Egyenlet_A
Egy_A#f_enl_el#_nle_gye_fel_let_#Eg_et#_t#A_#A#_#fe_yen	Egyenlet_A_fel
el#_A#f_izs_zsg_fel_l#l_lvi_viz_#A#_#lv_#fe_sg#	A_fel_lvizsg
g#l_el#_izs_l#l_fel_lvi_viz_lt#_#lv_zsg_#lt_#fe_sg#	fel_lvizsg_lt
cor_orl_g#l_izs_t#R_esc_viz_lvi_Res_la#_#Re_lt#_#lv_zsg_#lt_rla_sg#_sco	lvizsg_lt_Rescorla
orl_a#W_t#R_agn_esc_Wag_ner_er#_la#_Res_#Re_lt#_rla_cor_#lt_gne_#Wa_sco	lt_Rescorla_Wagner
ner_Wag_#mo_del_rla_sco_orl_esc_er#_mod_cor_ell_a#W_ode_agn_la#_r#m_ll#_Res_#Re_gne_#Wa	Rescorla_Wagner_modell
r#m_ode_#Va_agn_Wag_ner_er#_#mo_ll#_del_l#V_Van_an#_mod_gne_#Wa_ell	Wagner_modell_Van
Ham_mme_ode_#Va_#mo_ll#_del_l#V_n#H_Van_an#_mod_#Ha_me#_amm_ell	modell_Van_Hamme
Ham_mme_#Va_#t#_e#t_n#H_Van_an#_#Ha_me#_amm	Van_Hamme_t
Ham_mme_#t#_e#t_me#_#Ha_t#l_amm_#l#	Hamme_t_l
#t#_l#s_#s#_t#l_#l#	t_l_s
s#W_rma_ass_l#s_Was_man_#s#_sse_erm_an#_ser_#Wa_#l#	l_s_Wasserman
s#W_rma_#t#_ass_Was_man_#s#_n#t_sse_erm_an#_ser_#Wa	s_Wasserman_t
rma_#t#_ass_Was_man_n#t_sse_erm_an#_t#l_ser_#Wa_#l#	Wasserman_t_l
l#N_#t#_#N#_t#l_#l#	t_l_N
l#N_N#h_#N#_#h#_#l#	l_N_h
N#h_#N#_#h#_ny#_#ny_h#n	N_h_ny
ba#_#h#_ny#_hib_iba_#hi_y#h_#ny_h#n	h_ny_hiba
ba#_hib_ny#_a#a_iba_#a#_#hi_y#h_#ny	ny_hiba_a
cor_orl_a#R_esc_hib_a#a_#hi_iba_#a#_#Re_Res_rla_ba#_la#_sco	hiba_a_Rescorla
orl_a#W_a#R_esc_Wag_agn_ner_er#_la#_#a#_Res_#Re_rla_cor_gne_#Wa_sco	a_Rescorla_Wagner
ner_Wag_#mo_del_rla_sco_orl_esc_er#_mod_cor_ell_llb_ben_a#W_ode_agn_lbe_la#_r#m_Res_#Re_gne_#Wa_en#	Rescorla_Wagner_modellben
llb_ben_r#m_ode_agn_Wag_ner_er#_#mo_lbe_del_en#_mod_n#A_#A#_gne_#Wa_ell	Wagner_modellben_A
llb_or#_ben_ode_#mo_lbe_del_#ko_en#_kor_mod_n#A_#A#_A#k_ell	modellben_A_kor
or#_bba_r#b_#ko_kor_ban_an#_#A#_#bb_A#k	A_kor_bban
or#_cio_bba_ond_ici_r#b_#ko_kor_ban_an#_n#k_on#_kon_#bb_ndi_dic_ion	kor_bban_kondicion
cio_bba_n#l_ond_ici_#lt_#ko_ban_n#k_an#_on#_kon_#bb_ndi_dic_lt#_ion	bban_kondicion_lt
cio_t#g_n#l_ond_ici_#ko_#g#_lt#_on#_kon_dic_ndi_#lt_ion	kondicion_lt_g
t#g_tl#_#tl_g#t_lt#_#lt_#g#	lt_g_tl
l#m_gsz_tl#_#tl_egs_g#t_sz#_meg_#me_#g#	g_tl_megsz
l#m_gsz_#n#_z#n_tl#_#tl_egs_sz#_meg_#me	tl_megsz_n
gsz_#se_#n#_z#n_n#s_egs_sz#_se#_meg_#me	megsz_n_se
cio_#se_apo_#n#_e#j_n#s_ici_rap_on#_ozi_se#_#jr_zic_poz_ion_jra	n_se_jrapozicion
cio_#se_apo_e#j_ici_rap_on#_ozi_se#_#jr_n#l_zic_poz_#l#_ion_jra	se_jrapozicion_l
cio_apo_ici_l#s_rap_on#_ozi_#s#_#jr_n#l_zic_poz_#l#_ion_jra	jrapozicion_l_s
s#a_l#s_#s#_#a#_#l#	l_s_a
a#k_s#a_hal_#ki_#a#_#s#_kih_al#_iha	s_a_kihal
a#k_hal_#ki_l#s_#a#_#s#_kih_al#_iha	a_kihal_s
hal_#ki_l#s_#s#_s#u_kih_#ut_ut#_al#_iha	kihal_s_ut
t#n_#n#_#s#_s#u_#ut_ut#	s_ut_n
t#n_#n#_#ut_ut#_#A#_n#A	ut_n_A
#se_#n#_rke_erk_ent_A#s_nt#_#A#_n#A_ser_ken	n_A_serkent
#se_rke_erk_ent_A#s_#s#_nt#_t#s_#A#_ser_ken	A_serkent_s
#se_rke_erk_ent_s#s_#s#_nt#_t#s_ser_ken	serkent_s_s
#a#_#s#_s#a_s#s	s_s_a
s#a_#a#_#s#_a#g_#g#	s_a_g
tl#_#tl_g#t_a#g_#a#_#g#	a_g_tl
l#s_tl#_#tl_g#t_#s#_#g#	g_tl_s
#ki_l#s_tl#_#tl_s#k_#s#_kiz_iz#	tl_s_kiz
#ki_#r#_s#k_#s#_z#r_kiz_iz#	s_kiz_r
#la_lag_ago_#ki_#r#_oss_gos_z#r_r#l_kiz_ss#_iz#	kiz_r_lagoss
#la_lag_ago_#r#_oss_gos_ga#_r#l_ss#_s#g_#ga	r_lagoss_ga
#la_lag_ago_oss_gos_ga#_a#j_#j#_ss#_s#g_#ga	lagoss_ga_j
j#i_nge_ger_ga#_er#_#j#_ing_#in_a#j_#ga	ga_j_inger
j#i_#p#_r#p_nge_ger_er#_#j#_ing_#in	j_inger_p
#p#_r#p_p#r_ros_os#_ger_nge_er#_ing_#in_#ro	inger_p_ros
#p#_p#r_ros_#t#_os#_#ro_s#t	p_ros_t
sa#_ros_#t#_os#_t#s_#sa_#ro_s#t	ros_t_sa
sa#_#t#_a#a_#a#_t#s_#sa	t_sa_a
cio_a#k_sa#_ond_ici_a#a_#ko_#a#_kon_on#_#sa_dic_ndi_ion	sa_a_kondicion
cio_a#k_n#l_ond_ici_#ko_#a#_lt#_on#_kon_dic_ndi_#lt_ion	a_kondicion_lt
cio_t#g_n#l_ond_ici_#ko_#g#_lt#_on#_kon_dic_ndi_#lt_ion	kondicion_lt_g
t#g_tl#_#tl_g#t_lt#_#lt_#g#	lt_g_tl
val_tl#_l#v_#tl_#va_g#t_al#_#g#	g_tl_val
val_l#C_#CS_#va_l#v_tl#_#tl_al#_CS#	tl_val_CS
val_l#C_eex_xpo_pre_exp_#CS_osu_#va_ure_S#p_ree_re#_sur_pos_al#_#pr_CS#	val_CS_preexposure
eex_xpo_pre_exp_#CS_osu_#ha_ure_S#p_at#_ree_re#_sur_e#h_pos_hat_#pr_CS#	CS_preexposure_hat
eex_xpo_sa#_pre_exp_osu_#sa_#ha_ure_ree_re#_sur_e#h_t#s_pos_hat_#pr_at#	preexposure_hat_sa
sa#_#sa_#ha_t#s_hat_at#_a#l_#l#	hat_sa_l
ens_sa#_ns#_#te_ten_#sa_l#t_a#l_#l#	sa_l_tens
ns#_s#g_#te_ten_l#t_ens_#l#_#g#	l_tens_g
ns#_s#g_tl#_#te_#tl_g#t_ten_ens_#g#	tens_g_tl
l#s_tl#_#tl_g#t_#s#_#g#	g_tl_s
gas_l#s_s#M_aga_tl#_#tl_asa_#s#_abb_#Ma_Mag_bb#_sab	tl_s_Magasabb
gas_ren_b#r_nd#_s#M_aga_end_asa_#s#_abb_#Ma_Mag_bb#_sab_#re	s_Magasabb_rend
ren_nd#_ond_Mag_gas_aga_#ko_d#k_b#r_dic_bb#_ndi_#re_cio_end_asa_abb_kon_sab_ici_#Ma_on#_ion	Magasabb_rend_kondicion
cio_ren_nd#_n#l_ond_ici_end_#ko_on#_d#k_kon_dic_ndi_#re_#l#_ion	rend_kondicion_l
cio_n#l_ond_ici_l#s_#ko_#s#_on#_kon_dic_ndi_#l#_ion	kondicion_l_s
l#s_#s#_#rz_s#r_#l#_rz#	l_s_rz
erv_vi#_#ks_sze_#s#_zer_ksz_#rz_s#r_z#k_rvi_rz#	s_rz_kszervi
erv_vi#_el#_#ks_sze_i#e_#el_zer_ksz_#rz_z#k_rvi_rz#	rz_kszervi_el
cio_erv_vi#_l#k_el#_ond_ici_#ks_sze_i#e_#ko_#el_zer_ksz_on#_kon_dic_ndi_rvi_ion	kszervi_el_kondicion
cio_l#k_el#_n#l_ond_ici_#ko_#el_on#_kon_dic_ndi_#l#_ion	el_kondicion_l
cio_n#l_ond_ici_l#s_#ko_#s#_on#_kon_dic_ndi_#l#_ion	kondicion_l_s
s#H_Hiv_l#s_iva_vat_#s#_tko_koz_atk_oz#_#l#_#Hi	l_s_Hivatkoz
ok#_s#H_Hiv_#so_sok_iva_z#s_vat_#s#_tko_koz_atk_oz#_#Hi	s_Hivatkoz_sok
#K#_ok#_Hiv_#so_sok_iva_z#s_vat_k#K_tko_koz_atk_oz#_#Hi	Hivatkoz_sok_K
ok#_sok_#so_ls#_K#l_k#K_#ls_#K#	sok_K_ls
koz_ls#_iva_hiv_s#h_vat_K#l_tko_#hi_#ls_#K#_atk_oz#	K_ls_hivatkoz
ok#_#so_sok_ls#_iva_hiv_s#h_vat_tko_#hi_#ls_koz_atk_oz#_z#s	ls_hivatkoz_sok
ok#_#so_sok_iva_hiv_vat_For_#Fo_k#F_tko_orr_#hi_koz_atk_oz#_rr#_z#s	hivatkoz_sok_Forr
ok#_sok_#so_#Fo_k#F_orr_r#s_For_rr#	sok_Forr_sok
ok#_ker_#so_sok_k#S_er#_ike_#Fo_orr_r#s_#Si_For_rr#_Sik	Forr_sok_Siker
ok#_ker_sok_#so_k#S_er#_ike_#s#_r#s_#Si_Sik	sok_Siker_s
ker_s#a_er#_ike_#s#_#a#_r#s_#Si_Sik	Siker_s_a
s#a_#n#_#a#_#s#_a#n	s_a_n
#ps_#n#_psz_er#_sze_#a#_zer_a#n_n#p	a_n_pszer
#ps_#n#_psz_er#_sze_#s#_zer_r#s_n#p	n_pszer_s
#ps_psz_er#_sze_#s#_zer_r#s_s#g_#g#	pszer_s_g
#sz_g#s_rke_erk_kes_sze_esz_#s#_szt_zer_zt#_s#g_#g#	s_g_szerkeszt
#sz_g#s_rke_erk_kes_sze_esz_szt_#s#_zer_t#s_zt#_#g#	g_szerkeszt_s
#sz_rke_erk_kes_sze_esz_szt_#s#_zer_t#s_zt#_s#A_#A#	szerkeszt_s_A
RES_RLA_ESC_SCO_#RE_COR_#s#_#A#_s#A_A#R_ORL_LA#	s_A_RESCORLA
RES_A#W_RLA_WAG_ESC_SCO_NER_#RE_COR_ER#_#WA_#A#_AGN_GNE_A#R_ORL_LA#	A_RESCORLA_WAGNER
#MO_ESC_SCO_R#M_ODE_NER_ELL_COR_MOD_GNE_ORL_LA#_RES_ER#_#WA_AGN_A#W_WAG_DEL_#RE_LL#_RLA	RESCORLA_WAGNER_MODELL
#MO_SIK_IKE_R#M_ODE_NER_ELL_MOD_ERE_GNE_ESS_RES_ER#_AGN_#WA_#SI_WAG_KER_DEL_L#S_LL#_SS#	WAGNER_MODELL_SIKERESS
RES_#MO_SIK_DEL_KER_IKE_ELL_MOD_ESS_ERE_L#S_#SI_S#G_LL#_ODE_#G#_SS#	MODELL_SIKERESS_G
RES_KER_SIK_IKE_EK#_#NE_ERE_NEK_#SI_S#G_G#N_ESS_#G#_SS#	SIKERESS_G_NEK
EK#_K#S_NEK_#NE_G#N_#G#_#S#	G_NEK_S
S#N_EK#_K#S_#N#_NEK_#NE_#S#	NEK_S_N
S#N_SZE_#N#_N#P_ZER_ER#_#PS_PSZ_#S#	S_N_PSZER
SZE_#N#_N#P_ZER_R#S_ER#_#PS_PSZ_#S#	N_PSZER_S
SZE_ZER_R#S_ER#_S#G_#PS_PSZ_#G#_#S#	PSZER_S_G
EK#_NEK_S#G_#NE_G#N_#G#_#S#	S_G_NEK
KAI_EK#_AI#_#OK_NEK_#NE_G#N_OKA_#G#_K#O	G_NEK_OKAI
I#t_KAI_EK#_#tu_tud_#OK_NEK_#NE_OKA_ud#_AI#_K#O	NEK_OKAI_tud
gen_KAI_#tu_ner_#ge_er#_tud_d#g_#OK_ene_I#t_OKA_ud#_AI#	OKAI_tud_gener
gen_#tu_ner_#ge_er#_ni#_tud_d#g_ene_lni_r#l_ud#_#ln	tud_gener_lni
gen_i#v_#vi_ner_#ge_er#_ni#_ene_lni_r#l_vil_il#_#ln	gener_lni_vil
i#v_#vi_ni#_os#_gos_#go_lni_vil_l#g_il#_#ln	lni_vil_gos
#vi_os#_gos_#go_s#s_#s#_vil_l#g_il#	vil_gos_s
ord_#or_din_os#_gos_#go_s#s_#s#_s#o_rdi_in#	gos_s_ordin
ord_lis_#li_#or_din_#s#_s#o_n#l_is#_rdi_in#	s_ordin_lis
ord_lis_s#j_#li_#or_din_#j#_n#l_is#_rdi_in#	ordin_lis_j
lis_s#j_kat_lat_#li_oka_at#_tok_#j#_sla_j#s_ato_is#_#sl	lis_j_slatokat
kat_lat_#t#_oka_at#_tok_#j#_sla_j#s_ato_t#t_#sl	j_slatokat_t
kat_lat_#t#_oka_tok_bb#_sla_#bb_at#_t#b_ato_t#t_#sl	slatokat_t_bb
res_ker_es#_#t#_ere_ike_bb#_#si_#bb_sik_t#b_b#s	t_bb_sikeres
res_ker_es#_s#j_ere_ike_bb#_#j#_#si_sik_#bb_b#s	bb_sikeres_j
res_ker_es#_s#j_lat_ike_ata_#j#_#si_sla_sik_j#s_ere_ta#_#sl	sikeres_j_slata
lat_#va_ata_#j#_sla_an#_j#s_van_a#v_ta#_#sl	j_slata_van
lgo_#fe_lat_n#f_ldo_#va_ata_fel_sla_dol_an#_goz_oz#_eld_van_olg_a#v_ta#_#sl	slata_van_feldolgoz
lgo_#fe_n#f_ldo_#va_fel_#s#_an#_goz_oz#_eld_van_olg_z#s_dol	van_feldolgoz_s
lgo_ese_ldo_#es_set_fel_#s#_goz_et#_s#e_oz#_eld_#fe_olg_z#s_dol	feldolgoz_s_eset
t#n_#es_#n#_set_#s#_et#_s#e_ese	s_eset_n
t#n_#es_n#a_#n#_set_az#_et#_#az_ese	eset_n_az
enz_zit_z#i_n#a_nzi_#n#_int_it#_az#_nte_#az_#in_ten	n_az_intenzit
enz_zit_nak_z#i_nzi_sna_int_it#_#sn_az#_nte_t#s_ak#_#az_#in_ten	az_intenzit_snak
enz_zit_nak_nzi_sna_int_it#_#sn_#s#_nte_t#s_ak#_k#s_#in_ten	intenzit_snak_s
#v#_nak_sna_#sn_s#v_#s#_k#s_ak#	snak_s_v
ans_#v#_ns#_v#r_s#v_rat_#s#_lan_#ra_tla_atl	s_v_ratlans
ans_#v#_nak_ns#_gna_#gn_v#r_rat_lan_#ra_ak#_tla_atl_s#g	v_ratlans_gnak
ans_nak_ns#_k#i_gna_#gn_int_ntu_rat_#in_uit_tui_lan_#ra_ak#_it#_tla_atl_s#g	ratlans_gnak_intuit
#v#_nak_k#i_gna_#gn_int_ntu_uit_it#_tui_ak#_#in_t#v	gnak_intuit_v
v#h_#v#_int_ntu_uit_it#_#ha_tui_hat_at#_#in_t#v	intuit_v_hat
v#h_#v#_sa#_hat_#sa_#ha_t#s_at#	v_hat_sa
sa#_#sa_#ha_#va_t#s_an#_van_hat_at#_a#v	hat_sa_van
jel_sa#_#je_n#j_#va_ent_nt#_an#_len_#sa_van_ele_a#v	sa_van_jelent
jel_#je_n#j_#va_ent_#s#_nt#_t#s_an#_len_van_ele	van_jelent_s
jel_nt#_zti_iku_ele_isz_kus_#je_uri_s#h_ent_eur_heu_tik_#s#_t#s_ris_#he_szt_len_us#	jelent_s_heurisztikus
#he_isz_kus_uri_s#h_eur_heu_szt_#s#_tik_ris_#rt_rt#_zti_iku_s#r_us#	s_heurisztikus_rt
#he_isz_#ke_kus_uri_eur_heu_szt_tik_#rt_ris_rt#_zti_iku_s#r_ket_et#_us#_t#k	heurisztikus_rt_ket
#ke_t#n_ny#_#rt_ket_rt#_et#_#ny_t#k	rt_ket_ny
t#n_#ke_jt#_ny#_y#j_ket_et#_#jt_#ny	ket_ny_jt
isz_lag_vis_#vi_jt#_y#j_ny#_zon_ony_nyl_#jt_yla_#ny_t#v_szo_ag#	ny_jt_viszonylag
g#k_isz_lag_#ke_vis_#vi_kev_ev#_jt#_zon_ony_nyl_#jt_yla_t#v_szo_ag#	jt_viszonylag_kev
g#k_isz_lag_#ke_vis_#vi_v#s_kev_ev#_zon_#s#_ony_nyl_yla_szo_ag#	viszonylag_kev_s
#ke_#sz_bad_v#s_kev_ev#_sza_s#s_#s#_ad#_zab_aba	kev_s_szabad
#sz_bad_par_am#_sza_ara_s#s_#pa_#s#_ad#_zab_aba_ram_d#p	s_szabad_param
m#t_bad_#sz_par_am#_sza_ter_ara_#te_er#_#pa_ad#_aba_zab_ram_d#p	szabad_param_ter
m#t_par_am#_ter_er#_ara_#te_#pa_#s#_ram_r#s	param_ter_s
#f#_ter_er#_#te_#s#_s#f_r#s	ter_s_f
etl_#f#_tle_gge_#s#_s#f_f#g_get_len_#gg_en#	s_f_ggetlen
etl_#v#_#f#_tle_n#v_gge_get_f#g_len_#gg_en#	f_ggetlen_v
lto_etl_#v#_tle_n#v_gge_v#l_get_toz_len_#lt_#gg_oz#_en#	ggetlen_v_ltoz
lto_#v#_kat_v#l_#ka_at#_toz_#lt_z#k_oz#	v_ltoz_kat
lto_rta_kat_lma_maz_alm_art_tal_#ka_at#_tar_az#_toz_#ta_#lt_z#k_oz#_t#t	ltoz_kat_tartalmaz
rta_kat_lma_maz_#ke_alm_art_kev_tal_ev#_#ka_tar_az#_#ta_at#_z#k_t#t	kat_tartalmaz_kev
rta_maz_lma_#ke_alm_art_kev_tal_ev#_tar_v#s_az#_#s#_#ta_z#k	tartalmaz_kev_s
enc_#ke_ren_v#s_kev_ev#_ure_#ko_s#k_#s#_ci#_onk_nci_kon_nku_kur	kev_s_konkurenci
enc_ren_i#j_#ja_ure_#ko_s#k_#s#_ci#_onk_nci_kon_nku_ja#_kur	s_konkurenci_ja
enc_ren_vol_i#j_#ja_olt_#vo_ure_#ko_ci#_onk_lt#_nci_kon_nku_ja#_a#v_kur	konkurenci_ja_volt
ja#_#m#_#ja_olt_#vo_lt#_t#m_vol_a#v	ja_volt_m
#m#_m#s_olt_#vo_#s#_lt#_t#m_vol	volt_m_s
lm#_elm_#m#_m#s_#s#_#el_s#e	m_s_elm
#le_lm#_elm_kt#_ekt_#s#_#el_m#l_let_s#e_tek_ete	s_elm_letekt
#le_lm#_elm_ekt_let_#el_m#l_kt#_t#l_tek_#l#_ete	elm_letekt_l
#le_l#A_ekt_let_#A#_kt#_t#l_tek_#l#_ete	letekt_l_A
ode_#mo_#l#_ll#_del_#A#_mod_A#m_l#A_ell	l_A_modell
apv_l#a_pve_ode_ala_vet_#mo_ll#_del_#al_mod_#A#_et#_A#m_lap_ell	A_modell_alapvet
apv_l#a_elt_pve_ode_ala_t#f_#mo_ll#_del_fel_#al_mod_lap_et#_lt#_#fe_vet_ell	modell_alapvet_felt
apv_elt_tel_pve_ala_t#f_#te_fel_ez#_#al_et#_lap_lt#_lez_#fe_vet_ele_t#t	alapvet_felt_telez
tel_#se_#te_fel_sei_ez#_ei#_lt#_lez_#fe_elt_ele_t#t_z#s	felt_telez_sei
tel_#se_#sz_rke_erk_#te_kes_sei_sze_esz_szt_ez#_ei#_zer_zt#_i#s_z#s_lez_ele	telez_sei_szerkeszt
#se_#sz_rke_erk_kes_sei_sze_esz_szt_zer_ei#_zt#_t#s_#s#_i#s	sei_szerkeszt_s
#sz_rke_erk_kes_sze_esz_szt_#s#_zer_t#s_zt#_s#A_#A#	szerkeszt_s_A
meg_lep_epe_pet_#s#_egl_#A#_s#A_et#_gle_A#m_#me	s_A_meglepet
lep_epe_A#m_pet_#s#_t#s_#A#_egl_et#_gle_meg_#me	A_meglepet_s
lep_epe_nag_gys_ys#_pet_#s#_s#n_t#s_et#_egl_gle_meg_#me_agy_#na	meglepet_s_nagys
nag_gys_ys#_ga#_#s#_s#n_s#g_#ga_agy_#na	s_nagys_ga
ami_nag_gys_ys#_it#_ga#_a#a_mit_#am_s#g_#ga_agy_#na	nagys_ga_amit
ami_it#_ga#_a#a_t#a_mit_#a#_#am_#ga	ga_amit_a
erv_ami_#sz_zet_rve_vez_eze_it#_sze_t#a_mit_#a#_zer_#am_et#_a#s	amit_a_szervezet
erv_#sz_zta_sze_a#s_asz_vez_pas_zer_et#_al#_apa_rve_tal_eze_#a#_zet_tap_szt_#ta_t#t	a_szervezet_tapasztal
erv_ami_#sz_zta_iko_sze_mik_asz_vez_pas_kor_zer_et#_al#_#am_apa_or#_l#a_rve_tal_eze_zet_tap_szt_#ta_t#t	szervezet_tapasztal_amikor
or#_l#a_asz_ami_r#t_zta_tal_pas_tap_iko_szt_kor_mik_#ta_al#_#am_apa	tapasztal_amikor_tal
or#_zik_ami_al#_r#t_iko_tal_ik#_l#l_lko_kor_#lk_mik_ozi_#am_#ta_koz	amikor_tal_lkozik
zik_k#e_#eg_tal_ik#_egy_l#l_lko_ozi_#lk_gy#_#ta_al#_koz	tal_lkozik_egy
zik_k#e_#eg_egy_ik#_gy#_lko_ozi_#lk_fel_lt#_koz_#fe_elt_y#f	lkozik_egy_felt
#eg_tle_egy_#tl_gy#_fel_lt#_t#t_len_#fe_elt_y#f_en#	egy_felt_tlen
rel_el#_tle_nge_#tl_ger_fel_#in_err_ing_rre_lt#_len_#fe_elt_t#t_en#_n#i	felt_tlen_ingerrel
rel_US#_el#_tle_#US_nge_#tl_ger_err_rre_ing_l#U_len_#in_en#_n#i	tlen_ingerrel_US
het_elt_rel_US#_el#_#US_ger_nge_S#f_err_fel_rre_ing_lte_l#U_ehe_et#_#fe_#in_teh	ingerrel_US_feltehet
het_US#_t#e_#en_#US_S#f_fel_lte_ehe_et#_#fe_elt_teh_en#	US_feltehet_en
het_t#e_#en_n#f_#f#_lte_fel_ehe_et#_#fe_elt_teh_en#	feltehet_en_f
#en_n#f_#f#_f#g_#gg_gg#_en#	en_f_gg
g#a_#f#_#a#_f#g_#gg_gg#	f_gg_a
a#k_#k#_g#a_#a#_#gg_gg#	gg_a_k
a#k_#k#_#s#_#a#_k#s	a_k_s
#k#_rle_#s#_let_k#s_#rl_et#_s#r	k_s_rlet
or#_#so_rle_#s#_let_t#s_sor_#rl_et#_s#r	s_rlet_sor
or#_#so_rle_#n#_let_sor_t#s_r#n_#rl_et#	rlet_sor_n
or#_jel_#so_#je_enl_#n#_ev#_n#j_nle_sor_r#n_len_lev_ele	sor_n_jelenlev
jel_v#j_#je_enl_#n#_ev#_n#j_ek#_nle_len_lek_lev_ele	n_jelenlev_jelek
jel_ssz_v#j_zes_#je_enl_#ss_ev#_ek#_es#_nle_sze_k#s_len_lek_lev_ele	jelenlev_jelek_sszes
jel_tt#_ssz_es#_zes_#je_tet_#ss_ek#_ett_#te_sze_k#s_lek_ele_s#t	jelek_sszes_tett
oci_zoc_ssz_es#_zes_tet_ett_#ss_ass_cia_iat_#te_sze_t#a_#as_at#_tt#_szo_s#t	sszes_tett_asszociat
oci_zoc_ssz_#v#_ett_tet_ass_cia_iat_#te_t#v_t#a_#as_at#_tt#_szo	tett_asszociat_v
oci_zoc_ssz_#v#_ass_cia_iat_v#r_#rt_#as_rt#_at#_t#v_szo	asszociat_v_rt
#v#_#k#_v#r_#rt_rt#_t#k	v_rt_k
#k#_#t#_k#t_#rt_rt#_t#k	rt_k_t
#k#_#t#_k#t_t#l_#l#	k_t_l
#Ez_#t#_Ez#_l#E_t#l_#l#	t_l_Ez
#Ez_Ez#_l#E_#a#_z#a_#l#	l_Ez_a
#Ez_Ez#_a#f_fel_#a#_lt#_z#a_#fe_elt	Ez_a_felt
tel_a#f_#te_fel_#a#_ez#_lt#_lez_#fe_elt_ele_t#t	a_felt_telez
tel_#te_fel_#s#_ez#_lt#_lez_#fe_elt_ele_t#t_z#s	felt_telez_s
elt_tel_#te_#s#_#el_ez#_lt#_s#e_z#s_lez_ele	telez_s_elt
#r#_#s#_#el_t#r_lt#_s#e_elt	s_elt_r
r#a_#r#_#a#_t#r_#el_lt#_elt	elt_r_a
or#_a#k_r#a_#r#_#ko_#a#_kor	r_a_kor
or#_bbi_a#k_bi#_r#b_#ko_#a#_kor_#bb	a_kor_bbi
or#_bbi_ode_bi#_r#b_i#m_#ko_#mo_kor_del_lle_ekt_mod_kt#_lek_#bb_ell	kor_bbi_modellekt
bbi_ode_bi#_#mo_i#m_lle_del_ekt_mod_kt#_lek_#bb_#l#_ell_t#l	bbi_modellekt_l
l#a_ode_yek_ek#_#mo_lle_ekt_del_ely_ame_mel_lye_mod_kt#_t#l_lek_#am_#l#_ell	modellekt_l_amelyek
l#a_yek_ek#_ely_lye_ame_mel_k#a_#a#_#am_#l#	l_amelyek_a
cio_a#k_yek_ek#_ond_ici_ely_#ko_lye_ame_mel_k#a_#a#_#am_on#_kon_dic_ndi_ion	amelyek_a_kondicion
cio_a#k_n#l_ond_ici_#ko_#a#_lt#_on#_kon_dic_ndi_#lt_ion	a_kondicion_lt
cio_elt_#fe_n#l_ond_ici_t#f_#ko_fel_lt#_on#_kon_dic_ndi_#lt_ion	kondicion_lt_felt
tel_es#_t#f_les_#te_fel_lt#_#lt_#fe_elt_ele_t#t	lt_felt_teles
ern_tel_es#_s#i_ek#_les_nge_#te_ger_fel_#in_rne_ing_lt#_nek_#fe_elt_ele_t#t	felt_teles_ingernek
ern_k#C_tel_es#_s#i_#CS_ek#_les_nge_#te_ger_rne_ing_nek_CS#_#in_ele	teles_ingernek_CS
S#c_ern_k#C_#cs_#CS_ek#_ger_nge_csa_rne_sak_ing_ak#_nek_CS#_#in	ingernek_CS_csak
S#c_#cs_#CS_csa_az#_sak_k#a_ak#_#az_CS#	CS_csak_az
oci_zoc_ssz_#cs_ass_cia_csa_iat_az#_sak_k#a_ak#_z#a_#as_#az_at#_szo	csak_az_asszociat
oci_zoc_ssz_#v#_ass_cia_iat_az#_#as_z#a_#az_at#_t#v_szo	az_asszociat_v
oci_zoc_ssz_#v#_ass_cia_iat_v#r_#rt_#as_rt#_at#_t#v_szo	asszociat_v_rt
#v#_#k#_v#r_#rt_rt#_t#k	v_rt_k
#k#_#t#_k#t_#rt_rt#_t#k	rt_k_t
tt#_#k#_#t#_k#t_ett_#ve_vet_t#v	k_t_vett
tt#_ett_#t#_#k#_#ve_vet_t#v_t#k	t_vett_k
fig_ett_#k#_lem_#ve_gye_igy_ele_be#_yel_emb_#fi_mbe_k#f_vet_tt#_t#k	vett_k_figyelembe
#k#_lem_Ser_rke_erk_ent_gye_be#_igy_yel_emb_e#S_#Se_#fi_nt#_mbe_k#f_ken_ele_fig	k_figyelembe_Serkent
lem_Ser_rke_erk_ent_gye_be#_igy_#s#_yel_emb_e#S_#Se_#fi_nt#_mbe_t#s_ken_ele_fig	figyelembe_Serkent_s
Ser_rke_erk_ent_s#s_#s#_nt#_#Se_t#s_ken	Serkent_s_s
#a#_#s#_s#a_s#s	s_s_a
s#a_#a#_#s#_a#g_#g#	s_a_g
tl#_#tl_g#t_a#g_#a#_#g#	a_g_tl
l#s_tl#_#tl_g#t_#s#_#g#	g_tl_s
l#s_tl#_#tl_lle_ent_#s#_#el_len_nt#_s#e_ell	tl_s_ellent
tes_es#_ent_lle_#te_#s#_#el_len_nt#_s#e_t#t_ell	s_ellent_tes
fun_tes_es#_#fu_nkc_ent_lle_#te_unk_#el_nt#_s#f_ci#_len_kci_t#t_ell	ellent_tes_funkci
fun_es#_tes_#fu_#k#_nkc_#te_unk_ci#_s#f_i#k_kci	tes_funkci_k
fun_Egy_#k#_#fu_nkc_unk_gy#_k#E_ci#_#Eg_i#k_kci	funkci_k_Egy
ern_Egy_#k#_y#i_ek#_nge_ger_gy#_k#E_rne_ing_#Eg_nek_#in	k_Egy_ingernek
ern_Egy_#cs_k#c_y#i_ek#_nge_ger_csa_gy#_rne_sak_ing_#Eg_ak#_nek_#in	Egy_ingernek_csak
ern_zit_it#_#cs_k#c_ek#_ger_nge_csa_poz_rne_sak_ing_#po_ozi_ak#_nek_k#p_#in	ingernek_csak_pozit
zit_#v#_#cs_csa_it#_sak_#po_ozi_ak#_k#p_poz_t#v	csak_pozit_v
oci_zit_#v#_ssz_zoc_v#a_ass_it#_#po_ozi_ci#_#as_poz_t#v_szo	pozit_v_asszoci
oci_#v#_ssz_zoc_v#a_ass_ci#_#as_i#c_#ci_szo	v_asszoci_ci
oci_zoc_ssz_ass_#s#_ci#_#as_i#c_#ci_i#s_szo	asszoci_ci_s
#er_eje_je#_#s#_ci#_#ci_rej_s#e_i#s_ere	ci_s_ereje
#er_eje_je#_#s#_rej_e#l_s#e_ere_#l#	s_ereje_l
#v#_#er_eje_je#_l#v_rej_e#l_ere_#l#	ereje_l_v
#v#_v#n_#n#_l#v_#l#	l_v_n
cio_#v#_v#n_#n#_ond_ici_#ko_n#k_on#_kon_dic_ndi_ion	v_n_kondicion
cio_n#l_#n#_ond_ici_#ko_n#k_lt#_on#_kon_dic_ndi_#lt_ion	n_kondicion_lt
cio_#se_n#l_ond_ici_erk_ser_rke_ken_#ko_ent_t#s_nt#_lt#_on#_kon_dic_ndi_#lt_ion	kondicion_lt_serkent
#se_rke_erk_#va_ent_vag_gy#_t#s_nt#_lt#_#lt_ser_ken_t#v_agy	lt_serkent_vagy
#se_rke_erk_#va_ent_vag_gy#_y#n_ega_#ne_nt#_neg_at#_gat_ser_ken_t#v_agy	serkent_vagy_negat
#v#_#va_vag_ega_gy#_t#v_#ne_neg_gat_at#_y#n_agy	vagy_negat_v
oci_#v#_ssz_zoc_gat_v#a_ass_cia_ega_iat_neg_#ne_#as_at#_t#v_szo	negat_v_asszociat
oci_#v#_ssz_zoc_v#a_ass_cia_iat_#as_at#_t#v_szo	v_asszociat_v
oci_zoc_ssz_#v#_#er_v#e_ass_cia_eje_iat_je#_#as_rej_at#_ere_t#v_szo	asszociat_v_ereje
#v#_#er_v#e_eje_je#_rej_e#l_ere_#l#	v_ereje_l
#v#_#er_eje_je#_l#v_rej_e#l_ere_#l#	ereje_l_v
#v#_v#n_#n#_l#v_#l#	l_v_n
cio_#v#_v#n_#n#_ond_ici_#ko_n#k_on#_kon_dic_ndi_ion	v_n_kondicion
cio_n#l_#n#_ond_ici_#ko_n#k_lt#_on#_kon_dic_ndi_#lt_ion	n_kondicion_lt
cio_t#g_n#l_ond_ici_#ko_#g#_lt#_on#_kon_dic_ndi_#lt_ion	kondicion_lt_g
t#g_tl#_#tl_g#t_lt#_#lt_#g#	lt_g_tl
#le_leh_tl#_#tl_l#l_g#t_ehe_et#_het_#g#	g_tl_lehet
#le_t#n_leh_tl#_#tl_l#l_ehe_em#_#ne_et#_nem_het	tl_lehet_nem
#le_t#n_leh_ehe_em#_#ne_m#l_et#_nem_het	lehet_nem_lehet
#le_#mi_ndk_ett_leh_ind_dke_min_ehe_em#_#ne_m#l_ket_et#_nem_t#m_het_tt#	nem_lehet_mindkett
#le_#mi_ndk_ett_#Az_Az#_leh_ind_dke_min_ehe_ket_et#_t#A_t#m_het_tt#	lehet_mindkett_Az
#mi_ndk_ett_#Az_Az#_z#i_ind_dke_nge_ger_min_er#_#in_ing_ket_t#A_tt#	mindkett_Az_inger
oci_zoc_ssz_z#i_Az#_#Az_r#a_ass_cia_nge_ger_er#_iat_ing_#as_at#_#in_szo	Az_inger_asszociat
oci_zoc_ssz_#v#_r#a_ass_cia_ger_nge_er#_iat_ing_#as_at#_#in_t#v_szo	inger_asszociat_v
oci_zoc_ssz_#v#_#er_v#e_ass_cia_eje_iat_je#_#as_rej_at#_ere_t#v_szo	asszociat_v_ereje
#v#_#er_e#k_#k#_v#e_eje_je#_rej_ere	v_ereje_k
zve_etl_#er_e#k_#k#_k#z_eje_tle_je#_rej_len_#zv_ere_vet_en#	ereje_k_zvetlen
zve_etl_#k#_k#z_tle_len_n#l_#zv_vet_#l#_en#	k_zvetlen_l
zve_etl_l#a_tle_#a#_len_n#l_#zv_vet_#l#_en#	zvetlen_l_a
l#a_vis_#vi_ise_#l#_ked_#a#_elk_ed#_lke_sel_a#v	l_a_viselked
ben_vis_#vi_sbe_ise_ked_#a#_elk_d#s_#sb_ed#_lke_sel_a#v_en#	a_viselked_sben
ben_vis_#vi_sbe_ise_n#v_#va_ked_d#s_elk_#sb_ed#_lke_an#_sel_van_en#	viselked_sben_van
zve_ezv_ben_eje_#ki_sbe_n#v_kif_#va_fej_ife_ve#_an#_n#k_jez_#sb_van_en#	sben_van_kifejezve
zve_ezv_ami_eje_#ki_kif_fej_#va_it#_ife_ve#_e#a_mit_an#_n#k_jez_#am_van	van_kifejezve_amit
zve_ezv_ami_eje_#ki_kif_fej_it#_ife_ve#_e#a_mit_kiv_iv#_jez_#am_t#k	kifejezve_amit_kiv
ami_#ki_it#_v#l_kiv_mit_iv#_lt#_#am_#lt_t#k	amit_kiv_lt
t#g_#ki_v#l_kiv_iv#_lt#_#lt_#g#	kiv_lt_g
t#g_ol#_tol_g#t_lt#_#to_#lt_#g#	lt_g_tol
ol#_l#N_tol_inc_g#t_#Ni_#to_ncs_Nin_cs#_#g#	g_tol_Nincs
ol#_l#N_tol_#m#_s#m_inc_#Ni_#to_ncs_Nin_cs#	tol_Nincs_m
#d#_#m#_s#m_inc_#Ni_ncs_Nin_cs#_m#d	Nincs_m_d
ern_d#m_#m#_mer_ni#_gis_ism_sme_rni_#me_egi_meg_#d#_m#d	m_d_megismerni
ern_d#m_mer_i#a_ni#_#az_gis_az#_ism_rni_#me_egi_meg_#d#_sme	d_megismerni_az
ern_z#i_mer_i#a_ni#_#az_nge_gis_ger_az#_ism_#in_rni_ing_ert_rt#_egi_meg_#me_sme	megismerni_az_ingert
z#i_nge_ger_ert_az#_t#a_#an_ing_rt#_an#_#az_#in	az_ingert_an
ger_ert_nge_#an_t#a_ing_#lk_lk#_rt#_an#_n#l_#in	ingert_an_lk
k#l_#an_#lk_lk#_an#_n#l_#l#	an_lk_l
k#l_ogy_gy#_#lk_lk#_hog_l#h_#ho_#l#	lk_l_hogy
y#m_gmu_uta_ogy_mut_gy#_egm_atn_tat_hog_tn#_l#h_meg_#me_#ho_#l#	l_hogy_megmutatn
y#m_n#n_gmu_uta_nk#_ogy_mut_gy#_egm_atn_#nk_tat_hog_tn#_meg_#me_#ho	hogy_megmutatn_nk
n#n_gmu_uta_nk#_mut_#a#_egm_atn_k#a_tat_tn#_meg_#me_#nk	megmutatn_nk_a
erv_#sz_nk#_zet_rve_vez_eze_sze_#a#_zer_k#a_et#_a#s_#nk	nk_a_szervezet
erv_#sz_zet_rve_vez_rea_eze_sze_eak_#a#_t#r_zer_ci#_et#_a#s_kci_#re_akc	a_szervezet_reakci
#it_erv_#sz_zet_rve_vez_rea_eze_it#_sze_eak_i#i_t#r_zer_ci#_et#_kci_#re_akc	szervezet_reakci_it
#it_rea_it#_eak_i#i_ci#_#A#_kci_t#A_#re_akc	reakci_it_A
#it_A#C_#CS_it#_#A#_CS#_t#A	it_A_CS
A#C_#CS_#f#_S#f_#A#_CS#	A_CS_f
f#r_#r#_#f#_#CS_S#f_CS#	CS_f_r
ze#_#sz_f#r_#r#_#f#_sze_r#s	f_r_sze
ze#_and_#sz_nd#_#r#_#ll_sze_lan_e#l_r#s_lla	r_sze_lland
ze#_and_#sz_nd#_d#A_#ll_sze_lan_e#l_lla_#A#	sze_lland_A
and_d#A_nd#_A#C_#CS_#ll_lan_lla_#A#_CS#	lland_A_CS
A#C_pha_#CS_lph_S#a_#al_#A#_alp_CS#_ha#	A_CS_alpha
pha_#CS_lph_a#f_#f#_S#a_#al_alp_CS#_ha#	CS_alpha_f
pha_f#r_#r#_#f#_lph_a#f_alp_#al_ha#	alpha_f_r
ze#_#sz_f#r_#r#_#f#_sze_r#s	f_r_sze
ze#_#sz_#r#_sze_em#_#ne_r#s_nem_e#n	r_sze_nem
ze#_#sz_bad_m#s_sza_sze_em#_#ne_zab_aba_ad#_nem_e#n	sze_nem_szabad
#sz_bad_m#s_d#h_sza_ogy_gy#_em#_#ne_zab_aba_ad#_hog_nem_#ho	nem_szabad_hogy
#v#_bad_#sz_d#h_sza_ogy_gy#_ad#_aba_zab_hog_#ho_y#v	szabad_hogy_v
lto_#v#_zzo_ogy_v#l_gy#_zon_on#_toz_hog_#lt_ozz_#ho_y#v	hogy_v_ltozzon
lto_#v#_zzo_n#a_v#l_zon_#a#_toz_on#_#lt_ozz	v_ltozzon_a
lto_a#k_zzo_#k#_n#a_zon_#a#_toz_on#_#lt_ozz	ltozzon_a_k
a#k_#k#_#s#_#a#_k#s	a_k_s
#k#_rle_#s#_let_k#s_#rl_et#_s#r	k_s_rlet
or#_#so_rle_#s#_let_t#s_sor_#rl_et#_s#r	s_rlet_sor
or#_#so_rle_#n#_let_sor_t#s_r#n_#rl_et#	rlet_sor_n
or#_n#g_#so_#n#_gy#_sor_r#n_#gy	sor_n_gy
n#g_#k#_y#k_#n#_gy#_#gy	n_gy_k
#pv_#k#_pvi_vis_y#k_ise_gy#_et#_k#p_sel_elh_het_#gy_lhe	gy_k_pviselhet
#pv_#k#_vis_pvi_ise_#az_az#_t#a_et#_k#p_sel_elh_het_lhe	k_pviselhet_az
#pv_and_vis_pvi_nd#_ise_#az_#ll_az#_t#a_lan_lla_et#_z#l_sel_elh_het_lhe	pviselhet_az_lland
val_and_nd#_#ll_#va_az#_lan_lla_z#l_al#_#az_d#v	az_lland_val
val_and_nd#_#ll_#va_lan_lla_#A#_al#_l#A_d#v	lland_val_A
val_jel_#je_ek#_#va_A#j_#A#_al#_lek_ele_l#A	val_A_jelek
jel_lya_#fo_yam_#je_ek#_ama_ata_A#j_mat_#A#_fol_lek_k#f_oly_ele_ta#	A_jelek_folyamata
jel_ama_oly_ele_nin_#je_ncs_yam_#fo_ek#_inc_ata_#ni_mat_fol_lek_lya_ta#_a#n_k#f_cs#	jelek_folyamata_nincs
yam_#fo_cs#_ama_nin_#ha_s#h_inc_ata_at#_#ni_mat_fol_hat_a#n_lya_oly_ta#_ncs	folyamata_nincs_hat
#ss_#ha_s#h_inc_ssa_#ni_t#s_al#_hat_ncs_at#_cs#_nin_sal	nincs_hat_ssal
l#a_#ss_#ha_ssa_#a#_t#s_al#_hat_at#_sal	hat_ssal_a
jel_l#a_leg_#je_enl_#ss_ssa_nle_gi#_#a#_ele_len_al#_egi_a#j_sal	ssal_a_jelenlegi
jel_leg_#je_enl_i#l_#ll_apo_ra#_nle_gi#_a#j_tra_#a#_pot_lla_len_egi_otr_lap_ele	a_jelenlegi_llapotra
jel_Ez#_i#l_apo_gi#_egi_otr_pot_ele_#je_enl_ra#_nle_leg_lla_#Ez_#ll_tra_a#E_len_lap	jelenlegi_llapotra_Ez
#Ez_#cs_Ez#_apo_ra#_#ll_z#c_csa_tra_sak_lla_a#E_lap_ak#_otr_pot	llapotra_Ez_csak
#Ez_#cs_Ez#_z#c_csa_sak_#a#_k#a_ak#	Ez_csak_a
jel_#cs_#je_ek#_csa_sak_#a#_ele_k#a_ak#_lek_a#j	csak_a_jelek
jel_#ak_#je_akt_ek#_ktu_a#j_#a#_k#a_tu#_lek_ele	a_jelek_aktu
jel_lis_#ak_#li_#je_u#l_akt_ek#_ktu_k#a_tu#_lek_is#_ele	jelek_aktu_lis
oci_lis_ssz_#ak_s#a_#li_u#l_ass_akt_zoc_ktu_cia_iat_#as_at#_tu#_is#_szo	aktu_lis_asszociat
oci_lis_ssz_zoc_s#a_#li_#v#_ass_cia_iat_#as_at#_is#_t#v_szo	lis_asszociat_v
oci_zoc_ssz_#v#_ass_cia_iat_v#r_#rt_#as_rt#_at#_t#v_szo	asszociat_v_rt
#v#_#ke_ke#_v#r_#rt_rt#_t#k	v_rt_ke
#ke_ke#_ely_e#a_#rt_ame_mel_ly#_rt#_#am_t#k	rt_ke_amely
y#m_gha_egh_#ke_ke#_at#_ely_e#a_ame_mel_ly#_#am_hat_meg_#me	ke_amely_meghat
y#m_gha_egh_at#_ely_ame_mel_ly#_t#r_#am_roz_hat_ozz_meg_#me_#ro_za#_zza	amely_meghat_rozza
meg_egh_at#_a#a_#a#_t#r_ozz_roz_hat_gha_#me_#ro_za#_zza	meghat_rozza_a
tan_anu_nul_a#t_ul#_a#a_#a#_roz_#ta_ozz_#ro_za#_zza	rozza_a_tanul
anu_tan_nul_l#s_a#t_ul#_#a#_#s#_#ta	a_tanul_s
anu_tan_nul_nny_yis_l#s_nyi_ul#_s#m_#s#_#ta_men_#me_is#_enn	tanul_s_mennyis
nny_yis_nyi_s#g_s#m_#s#_#g#_men_#me_is#_enn	s_mennyis_g
nny_#t#_yis_nyi_s#g_g#t_#g#_men_#me_is#_enn	mennyis_g_t
#t#_t#N_g#t_em#_Nem_#Ne_#g#	g_t_Nem
#t#_#sz_m#s_t#N_sz#_em#_Nem_#Ne	t_Nem_sz
#sz_#m#_m#s_sz#_em#_Nem_#Ne_z#m	Nem_sz_m
m#t_#m#_#sz_#t#_sz#_z#m	sz_m_t
m#t_#t#_#m#_ogy_gy#_t#h_hog_#ho	m_t_hogy
#t#_ogy_gy#_#a#_t#h_hog_y#a_#ho	t_hogy_a
a#C_#CS_ogy_gy#_#a#_hog_CS#_y#a_#ho	hogy_a_CS
S#t_#t#_#CS_#a#_CS#_a#C	a_CS_t
#t#_S#t_#CS_CS#_t#t	CS_t_t
bbs_#t#_bsz_sz#_#bb_t#b_t#t	t_t_bbsz
bbs_#t#_#r#_bsz_sz#_z#r_#bb_t#b	t_bbsz_r
bbs_#r#_bsz_sz#_z#r_r#i_#bb_is#_#is	bbsz_r_is
#r#_s#p_pr#_r#i_#is_#pr_is#	r_is_pr
s#p_pr#_r#b_#is_#b#_#pr_is#	is_pr_b
r#b_pr#_lt#_b#l_#b#_#pr_#lt	pr_b_lt
#k#_lt#_b#l_#b#_#lt_t#k	b_lt_k
gha_egh_hat_#k#_at#_lt#_#lt_meg_#me_t#k_k#m	lt_k_meghat
gha_egh_#k#_ni#_zni_at#_ozn_t#r_roz_hat_meg_#me_#ro_k#m	k_meghat_rozni
meg_egh_i#v_ni#_zni_at#_ozn_#va_vag_gy#_t#r_roz_hat_gha_#me_#ro_agy	meghat_rozni_vagy
has_son_i#v_aso_ni#_zni_#va_ozn_vag_gy#_#ha_onl_nl#_roz_y#h_#ro_agy	rozni_vagy_hasonl
has_son_aso_#Az_Az#_#va_vag_#ha_gy#_onl_nl#_y#h_l#A_agy	vagy_hasonl_Az
has_son_aso_#Az_Az#_els_ls#_#ha_z#e_#el_onl_nl#_l#A	hasonl_Az_els
#k#_els_Az#_#Az_ls#_z#e_s#k_#el	Az_els_k
#k#_els_k#t_ls#_#t#_s#k_#el	els_k_t
#k#_#t#_k#t_t#f_fel_lt#_#fe_elt	k_t_felt
tel_#t#_t#f_#te_fel_ez#_lt#_lez_#fe_elt_ele_t#t	t_felt_telez
tel_#te_fel_#s#_ez#_lt#_lez_#fe_elt_ele_t#t_z#s	felt_telez_s
#eg_tel_egy_#te_gye_yed_#s#_ez#_ed#_s#e_z#s_lez_ele	telez_s_egyed
#eg_d#l_egy_gye_#s#_ed#_s#e_yed_#l#	s_egyed_l
#eg_d#l_#ll_egy_gye_l#l_ll#_ed#_yed_#l#	egyed_l_ll
l#a_#ll_#an_ll#_l#l_an#_#l#	l_ll_an
l#a_n#a_#ll_#an_ll#_#a#_an#	ll_an_a
orl_n#a_a#R_esc_#an_la#_#a#_Res_#Re_an#_rla_cor_sco	an_a_Rescorla
orl_a#W_a#R_esc_Wag_agn_ner_er#_la#_#a#_Res_#Re_rla_cor_gne_#Wa_sco	a_Rescorla_Wagner
ner_Wag_#mo_del_rla_sco_orl_esc_er#_mod_cor_ell_a#W_ode_agn_la#_r#m_ll#_Res_#Re_gne_#Wa	Rescorla_Wagner_modell
jel_lem_r#m_ode_#je_agn_Wag_ner_er#_#mo_ll#_del_lle_mz#_mod_l#j_gne_#Wa_emz_ell	Wagner_modell_jellemz
jel_lem_ode_#je_mz#_je#_#mo_lle_ll#_del_z#j_mod_l#j_emz_ell	modell_jellemz_je
jel_e#A_lem_#Az_#je_Az#_mz#_je#_lle_z#j_emz_ell	jellemz_je_Az
z#u_e#A_tol_Az#_#Az_#je_ls#_uto_je#_#ut_ols	je_Az_utols
z#u_tol_Az#_#Az_ls#_uto_s#h_#h#_#ut_ols	Az_utols_h
h#r_tol_ls#_rom_uto_s#h_#h#_om#_#ut_ols_#ro	utols_h_rom
rom_m#f_#h#_om#_fel_lt#_h#r_#fe_elt_#ro	h_rom_felt
tel_rom_#te_om#_fel_lez_ele_ez#_lt#_m#f_#fe_elt_#ro_t#t	rom_felt_telez
tel_#te_fel_#s#_ez#_lt#_lez_#fe_elt_ele_t#t_z#s	felt_telez_s
jel_s#j_tel_#je_#te_#s#_ez#_len_z#s_lez_ele_en#	telez_s_jelen
jel_s#j_#je_n#v_olt_#vo_#s#_lt#_len_vol_ele_en#	s_jelen_volt
jel_t#e_#je_el#_n#v_olt_#vo_#el_lt#_len_vol_ele_en#	jelen_volt_el
t#e_el#_olt_#vo_l#z_#el_lt#_#z#_vol	volt_el_z
ben_ode_el#_#mo_lle_ekb_l#z_del_#el_kbe_en#_mod_lek_#z#_z#m_ell	el_z_modellekben
ben_ode_#mo_lle_ekb_del_kbe_en#_mod_#is_lek_#z#_is#_z#m_ell_n#i	z_modellekben_is
ben_ode_#mo_lle_ekb_del_kbe_en#_em#_#Ne_mod_#is_s#N_lek_Nem_is#_ell_n#i	modellekben_is_Nem
em#_#a#_#Ne_#is_s#N_m#a_Nem_is#	is_Nem_a
#le_tos_leg_nto_fon_bb#_em#_#a#_abb_gfo_sab_ont_m#a_Nem_#Ne_a#l_egf_osa	Nem_a_legfontosabb
#le_tos_leg_nto_b#r_#r#_fon_#a#_abb_gfo_ont_bb#_sab_a#l_egf_osa	a_legfontosabb_r
#le_tos_leg_ze#_#sz_nto_b#r_#r#_fon_sze_abb_gfo_r#s_ont_bb#_sab_egf_osa	legfontosabb_r_sze
ze#_#sz_#r#_sze_e#a_az#_r#s_#az	r_sze_az
lm#_elm_ze#_#sz_z#e_sze_e#a_az#_#el_#az	sze_az_elm
#le_lm#_elm_etn_ek#_z#e_az#_let_#el_m#l_nek_#az_tne	az_elm_letnek
#le_lm#_elm_etn_ek#_#de_let_#el_m#l_nek_tne_k#d_de#	elm_letnek_de
#le_jel_etn_#je_e#j_ek#_#de_ent_let_ele_nt#_nek_len_tne_k#d_de#	letnek_de_jelent
jel_#je_e#j_#de_ent_ele_#s#_nt#_t#s_len_de#	de_jelent_s
jel_s#a_#je_ent_#s#_#a#_nt#_t#s_len_ele	jelent_s_a
epe_s#a_#sz_sze_#a#_#s#_zer_a#s_ere_rep_pe#	s_a_szerepe
epe_Egy_#sz_enl_e#E_gye_sze_nle_#a#_let_zer_#Eg_yen_et#_a#s_ere_rep_pe#	a_szerepe_Egyenlet
Egy_#sz_e#E_gye_sze_esz_let_rep_enl_nle_kes_zer_#Eg_zt#_et#_ere_pe#_epe_erk_t#s_yen_rke_szt	szerepe_Egyenlet_szerkeszt
Egy_#sz_enl_rke_erk_nle_gye_sze_kes_let_esz_#Eg_t#s_zer_et#_szt_zt#_#s#_yen	Egyenlet_szerkeszt_s
#VX_#sz_rke_erk_Xn#_VXn_kes_sze_esz_szt_#s#_zer_t#s_zt#_s#V	szerkeszt_s_VXn
#VX_Xn#_#X#_VXn_n#X_#s#_s#V	s_VXn_X
#VX_Xn#_#X#_VXn_Vto_ot#_X#V_tot_#Vt_n#X	VXn_X_Vtot
isp_le#_dis_sty_#di_#X#_Vto_ot#_spl_lay_yst_tot_X#V_ays_yle_tyl_#Vt_t#d_pla	X_Vtot_displaystyle
isp_le#_ays_tyl_Del_lta_dis_sty_spl_t#d_ot#_Vto_#De_tot_elt_ta#_pla_#di_e#D_lay_yst_yle_#Vt	Vtot_displaystyle_Delta
isp_elt_a#V_le#_dis_sty_#V#_#di_spl_e#D_lay_yst_#De_ays_yle_ta#_tyl_pla_Del_lta	displaystyle_Delta_V
V#X_a#V_lta_#V#_#X#_#De_elt_Del_ta#	Delta_V_X
V#X_X#n_#V#_#n#_#X#	V_X_n
pha_n#a_X#n_#n#_lph_#X#_#al_alp_ha#	X_n_alpha
pha_n#a_#n#_lph_#X#_a#X_alp_#al_ha#	n_alpha_X
pha_bet_lph_#X#_a#X_alp_#al_ta#_#be_X#b_eta_ha#	alpha_X_beta
amb_#la_bet_#X#_da#_mbd_bda_ta#_#be_X#b_a#l_lam_eta	X_beta_lambda
amb_a#V_#la_bet_#V#_da#_eta_mbd_bda_#be_a#l_lam_ta#	beta_lambda_V
amb_a#V_#la_#V#_ot#_da#_mbd_V#t_tot_#to_bda_lam	lambda_V_tot
#V#_ot#_#s#_t#s_tot_V#t_#to	V_tot_s
#VX_Xn#_ot#_VXn_#s#_t#s_tot_#to_s#V	tot_s_VXn
#VX_n#V_Xn#_VXn_#s#_s#V	s_VXn_VXn
n#V_Xn#_#VX_VXn	VXn_VXn_VXn
n#d_isp_le#_#VX_dis_n#V_sty_Xn#_#di_VXn_spl_lay_yst_ays_yle_tyl_pla	VXn_VXn_displaystyle
n#d_isp_le#_#VX_dis_sty_Xn#_#di_#V#_VXn_spl_lay_yst_e#V_ays_yle_tyl_pla	VXn_displaystyle_V
V#X_isp_le#_dis_sty_#V#_#di_#X#_spl_lay_yst_e#V_ays_yle_tyl_pla	displaystyle_V_X
V#X_X#n_#V#_#n#_#X#	V_X_n
X#n_n#V_#n#_#V#_#X#	X_n_V
V#X_n#V_#n#_#V#_#X#	n_V_X
V#X_X#n_#V#_#n#_#X#	V_X_n
n#D_X#n_#n#_#X#_#De_ta#_elt_Del_lta	X_n_Delta
a#V_n#D_#n#_#V#_#De_ta#_elt_Del_lta	n_Delta_V
V#X_a#V_lta_#V#_#X#_#De_elt_Del_ta#	Delta_V_X
V#X_X#n_#V#_#n#_#X#	V_X_n
ol#_aho_n#a_X#n_#n#_#X#_hol_#ah	X_n_ahol
ol#_aho_n#a_#n#_#V#_l#V_hol_#ah	n_ahol_V
ol#_V#X_aho_#V#_#X#_l#V_hol_#ah	ahol_V_X
V#X_#V#_#X#_X#a_#a#	V_X_a
#v#_#X#_X#a_#a#_a#v	X_a_v
lto_#v#_v#l_#a#_toz_#lt_oz#_a#v	a_v_ltoz
lto_#v#_#az_v#l_az#_toz_z#a_#lt_oz#	v_ltoz_az
lto_#az_#X#_az#_z#a_toz_#lt_oz#_z#X	ltoz_az_X
oci_zoc_ssz_ass_#X#_X#a_az#_ci#_#as_#az_z#X_szo	az_X_asszoci
oci_zoc_ssz_ass_#X#_X#a_ci#_#as_i#c_#ci_szo	X_asszoci_ci
oci_zoc_ssz_#er_ass_er#_i#e_ci#_#as_i#c_#ci_szo	asszoci_ci_er
#er_#ss_er#_i#e_ci#_r#s_#ci_ss#	ci_er_ss
#er_#ss_er#_r#s_ss#_s#g_#g#	er_ss_g
ben_#ss_en#_g#b_ss#_#be_s#g_#g#	ss_g_ben
ben_n#a_#a#_g#b_#g#_#be_en#	g_ben_a
ugr_a#k_ben_gr#_n#a_#ki_kiu_#a#_#be_iug_en#	ben_a_kiugr
ugr_a#k_gr#_kiu_#ki_#a#_#s#_r#s_iug	a_kiugr_s
ugr_gr#_s#a_kiu_#ki_#s#_#a#_r#s_iug	kiugr_s_a
s#a_a#f_fel_#a#_#s#_lt#_#fe_elt	s_a_felt
tel_es#_a#f_les_#te_fel_#a#_lt#_#fe_elt_ele_t#t	a_felt_teles
tel_es#_s#i_les_nge_#te_ger_fel_#in_er#_ing_lt#_#fe_elt_ele_t#t	felt_teles_inger
tel_es#_s#i_r#h_les_nge_#te_ger_er#_#ha_ing_hat_at#_#in_ele	teles_inger_hat
rol_r#h_olt_ger_nge_er#_#ha_ing_t#r_lt#_hat_at#_#in_#ro	inger_hat_rolt
rol_olt_#ha_#s#_t#r_t#s_lt#_hat_at#_#ro	hat_rolt_s
rol_s#a_olt_az#_#s#_t#s_lt#_#az_#ro	rolt_s_az
US#_s#a_#US_az#_#s#_#az_z#U	s_az_US
US#_#US_S#a_ar#_az#_#ar_#az_z#U	az_US_ar
US#_#US_S#a_ar#_ny#_#ar_r#n_#ny	US_ar_ny
par_am#_y#p_ara_ar#_ny#_#pa_#ar_r#n_ram_#ny	ar_ny_param
m#t_par_ere_am#_ter_y#p_ara_#te_ny#_#pa_re#_ram_#ny	ny_param_tere
m#t_par_am#_ter_#ha_ara_#te_at#_#pa_re#_e#h_ram_hat_ere	param_tere_hat
rol_olt_ter_#ha_#te_at#_re#_t#r_e#h_lt#_hat_ere_#ro	tere_hat_rolt
rol_olt_#ha_#s#_t#r_t#s_lt#_hat_at#_#ro	hat_rolt_s
rol_#m#_olt_s#m_#s#_t#s_lt#_#ro	rolt_s_m
m#s_#s#_s#m_#m#	s_m_s
#m#_m#s_#n#_#s#_s#n	m_s_n
#n#_n#v_#ve_#s#_s#n_ven_en#	s_n_ven
n#a_#n#_n#v_#ve_az#_#az_ven_en#	n_ven_az
oci_zoc_ssz_szo_n#a_ass_#ve_az#_ci#_#as_z#a_#az_ven_en#	ven_az_asszoci
oci_zoc_ssz_ass_az#_ci#_#as_i#c_z#a_#ci_#az_szo	az_asszoci_ci
oci_zoc_ssz_ass_i#r_#rt_ci#_#as_i#c_rt#_#ci_szo	asszoci_ci_rt
#ke_ke#_i#r_#rt_ci#_rt#_#ci_t#k	ci_rt_ke
#ke_ke#_az#_e#a_#rt_rt#_#az_t#k	rt_ke_az
#ke_US#_ke#_#US_az#_e#a_#az_z#U	ke_az_US
#le_US#_leh_#US_ets_az#_ehe_S#l_#az_het_z#U_ts#	az_US_lehets
#le_US#_es#_leh_#US_#ge_ets_ges_ehe_S#l_het_s#g_ts#	US_lehets_ges
#le_es#_mum_leh_#ge_ges_ets_s#m_max_ehe_xim_um#_#ma_imu_het_s#g_ts#_axi	lehets_ges_maximum
m#k_ond_xim_axi_mum_#ko_dic_ndi_#ma_cio_es#_s#m_kon_ici_max_#ge_ges_um#_imu_on#_ion	ges_maximum_kondicion
cio_mum_m#k_n#l_ond_max_ici_um#_ion_#l#_#ko_xim_imu_on#_kon_dic_ndi_#ma_axi	maximum_kondicion_l
cio_l#j_n#l_ond_ici_#ja_#ko_on#_kon_dic_ndi_ja#_#l#_ion	kondicion_l_ja
a#V_#ja_#V#_l#j_ja#_#l#	l_ja_V
V#X_a#V_#ja_#V#_#X#_ja#	ja_V_X
V#X_#V#_#X#_X#a_#a#	V_X_a
jel_leg_#je_enl_#X#_nle_X#a_gi#_#a#_ele_len_egi_a#j	X_a_jelenlegi
jel_oci_zoc_gi#_egi_ele_#je_enl_cia_iat_nle_at#_leg_ass_#a#_#as_a#j_szo_ssz_i#a_len	a_jelenlegi_asszociat
jel_oci_zoc_gi#_egi_ele_#v#_#je_enl_cia_iat_nle_at#_leg_ass_#as_t#v_szo_ssz_i#a_len	jelenlegi_asszociat_v
oci_zoc_ssz_#v#_#er_v#e_ass_cia_iat_er#_#as_at#_t#v_szo	asszociat_v_er
r#V_#v#_#er_v#e_#V#_er#	v_er_V
r#V_#er_#t#_#V#_er#_V#t	er_V_t
#t#_t#o_#V#_V#t_#o#	V_t_o
t#o_o#t_#t#_#o#	t_o_t
#t#_o#t_t#a_#a#_#o#	o_t_a
tel_jes_#t#_es#_lje_a#t_#te_t#a_#a#_elj	t_a_teljes
oci_zoc_ssz_tel_jes_es#_s#a_ass_lje_cia_a#t_#te_iat_#a#_#as_elj_at#_szo	a_teljes_asszociat
oci_zoc_ssz_tel_jes_es#_s#a_ass_lje_cia_#v#_iat_#te_#as_elj_at#_t#v_szo	teljes_asszociat_v
oci_zoc_ssz_#v#_#er_v#e_ass_cia_eje_iat_je#_#as_rej_at#_ere_t#v_szo	asszociat_v_ereje
#v#_#er_v#e_eje_je#_az#_e#a_rej_#az_ere	v_ereje_az
#er_ssz_es#_zes_eje_#ss_je#_az#_e#a_sze_rej_#az_ere_z#s	ereje_az_sszes
ssz_es#_zes_s#a_#ss_az#_sze_#a#_#az_z#s	az_sszes_a
ssz_es#_zes_s#a_#ss_a#f_sze_fel_#a#_lt#_#fe_elt	sszes_a_felt
tel_es#_a#f_les_#te_fel_#a#_lt#_#fe_elt_ele_t#t	a_felt_teles
ern_tel_es#_s#i_ek#_les_nge_#te_ger_fel_#in_rne_ing_lt#_nek_#fe_elt_ele_t#t	felt_teles_ingernek
ern_tel_es#_s#i_ek#_les_nge_#te_ger_rne_ing_nek_#A#_k#A_#in_ele	teles_ingernek_A
ern_A#f_el#_ek#_ger_nge_fel_rne_ing_nek_#A#_k#A_#fe_#in	ingernek_A_fel
el#_A#f_izs_zsg_fel_l#l_lvi_viz_#A#_#lv_#fe_sg#	A_fel_lvizsg
g#l_el#_izs_l#l_fel_lvi_viz_lt#_#lv_zsg_#lt_#fe_sg#	fel_lvizsg_lt
cor_orl_g#l_izs_t#R_esc_viz_lvi_Res_la#_#Re_lt#_#lv_zsg_#lt_rla_sg#_sco	lvizsg_lt_Rescorla
orl_a#W_t#R_agn_esc_Wag_ner_er#_la#_Res_#Re_lt#_rla_cor_#lt_gne_#Wa_sco	lt_Rescorla_Wagner
ner_Wag_#mo_del_rla_sco_orl_esc_er#_mod_cor_ell_a#W_ode_agn_la#_r#m_ll#_Res_#Re_gne_#Wa	Rescorla_Wagner_modell
r#m_ode_#Va_agn_Wag_ner_er#_#mo_ll#_del_l#V_Van_an#_mod_gne_#Wa_ell	Wagner_modell_Van
Ham_mme_ode_#Va_#mo_ll#_del_l#V_n#H_Van_an#_mod_#Ha_me#_amm_ell	modell_Van_Hamme
Ham_mme_#Va_#t#_e#t_n#H_Van_an#_#Ha_me#_amm	Van_Hamme_t
Ham_mme_#t#_e#t_me#_#Ha_t#l_amm_#l#	Hamme_t_l
#t#_l#s_#s#_t#l_#l#	t_l_s
s#W_rma_ass_l#s_Was_man_#s#_sse_erm_an#_ser_#Wa_#l#	l_s_Wasserman
s#W_rma_#t#_ass_Was_man_#s#_n#t_sse_erm_an#_ser_#Wa	s_Wasserman_t
rma_#t#_ass_Was_man_n#t_sse_erm_an#_t#l_ser_#Wa_#l#	Wasserman_t_l
#sz_#t#_l#s_rke_erk_kes_sze_esz_szt_zer_zt#_t#l_#l#	t_l_szerkeszt
#sz_l#s_rke_erk_kes_sze_esz_szt_#s#_zer_t#s_zt#_#l#	l_szerkeszt_s
#sz_#Va_rke_erk_kes_sze_esz_szt_#s#_zer_t#s_zt#_Van_an#_s#V	szerkeszt_s_Van
Ham_mme_#Va_#s#_n#H_Van_an#_#Ha_me#_amm_s#V	s_Van_Hamme
Ham_mme_#Va_e#s_#s#_n#H_Van_an#_#Ha_me#_amm	Van_Hamme_s
s#W_Ham_mme_rma_e#s_ass_Was_man_ser_#s#_sse_erm_me#_#Ha_an#_amm_#Wa	Hamme_s_Wasserman
tte_s#W_zte_ett_man_rje_esz_sse_erj_Was_erm_te#_ser_rma_jes_tet_ass_#ki_#s#_an#_ite_kit_ter_szt_n#k_#Wa	s_Wasserman_kiterjesztette
tte_zte_ett_man_rje_esz_sse_erj_Was_erm_te#_#az_ser_rma_jes_tet_ass_#ki_an#_ite_kit_ter_szt_e#a_az#_n#k_#Wa	Wasserman_kiterjesztette_az
tte_zte_ett_rje_esz_erj_det_te#_#az_ere_#er_ti#_jes_tet_#ki_eti_kit_ite_red_ede_ter_z#e_szt_e#a_az#	kiterjesztette_az_eredeti
red_det_orl_#er_ede_ti#_eti_esc_z#e_az#_la#_Res_#Re_rla_cor_#az_i#R_ere_sco	az_eredeti_Rescorla
ner_Wag_rla_sco_det_orl_esc_er#_cor_ere_#er_ti#_a#W_eti_agn_la#_i#R_red_ede_Res_#Re_gne_#Wa	eredeti_Rescorla_Wagner
orl_RW#_a#W_r#R_#RW_agn_esc_Wag_ner_er#_la#_Res_#Re_rla_cor_gne_#Wa_sco	Rescorla_Wagner_RW
llt_r#R_#RW_ode_agn_Wag_ner_er#_#mo_del_lt#_W#m_mod_gne_#Wa_ell_RW#	Wagner_RW_modellt
llt_#RW_ode_#mo_del_#s#_t#s_lt#_mod_W#m_ell_RW#	RW_modellt_s
llt_s#j_ode_#mo_del_#s#_#j#_t#s_lt#_mod_ell	modellt_s_j
s#j_#t#_j#t_#s#_#j#	s_j_t
t#n_#t#_yez_j#t_#j#_ez#_#ny_nye	j_t_nyez
t#n_#t#_yez_ez#_z#t_#ny_nye	t_nyez_t
ott_uta_#t#_#mu_yez_mut_ez#_tot_z#t_tat_t#m_#ny_tt#_ato_nye	nyez_t_mutatott
t#b_ott_uta_#t#_#mu_mut_be#_tot_#be_tat_t#m_ato_tt#	t_mutatott_be
ott_uta_#mu_mut_be#_e#a_az#_tot_#be_tat_#az_t#b_ato_tt#	mutatott_be_az
az#_e#a_be#_#j#_z#j_#az_#be	be_az_j
#RW_az#_#j#_z#j_#az_j#R_RW#	az_j_RW
llb_ben_#RW_ode_#mo_lbe_del_#j#_en#_W#m_mod_j#R_ell_RW#	j_RW_modellben
llb_ben_#RW_ode_n#b_#mo_lbe_del_en#_mod_W#m_#be_ell_RW#	RW_modellben_ben
llb_Azt_ben_ode_#Az_n#b_#mo_lbe_del_en#_zt#_mod_n#A_#be_ell	modellben_ben_Azt
Azt_ben_vas_#Az_t#j_#ja_aso_sol_olt_zt#_lt#_n#A_jav_#be_en#_ava	ben_Azt_javasolt
Azt_vas_#k#_#Az_t#j_#ja_aso_sol_olt_zt#_lt#_jav_t#k_ava	Azt_javasolt_k
vas_#k#_sol_aso_#ja_k#h_olt_ogy_gy#_lt#_hog_jav_#ho_t#k_ava	javasolt_k_hogy
k#h_#k#_ogy_y#n_gy#_em#_#ne_hog_nem_#ho	k_hogy_nem
#cs_ogy_csa_y#n_gy#_sak_em#_#ne_ak#_hog_nem_#ho_m#c	hogy_nem_csak
#cs_csa_sak_em#_#ne_#a#_k#a_ak#_nem_m#c	nem_csak_a
cio_a#k_#cs_ond_ici_csa_#ko_sak_#a#_k#a_ak#_on#_kon_dic_ndi_ion	csak_a_kondicion
cio_a#k_n#l_ond_ici_#ko_#a#_lt#_on#_kon_dic_ndi_#lt_ion	a_kondicion_lt
cio_rek_n#l_ond_ici_t#i_nge_ger_ere_#ko_#in_ek#_ing_lt#_on#_kon_dic_ndi_#lt_ion	kondicion_lt_ingerek
rek_yek_t#i_ek#_nge_ger_ely_lye_ing_mel_#me_lt#_#lt_ere_#in_k#m	lt_ingerek_melyek
zik_rek_ika_izi_nge_ing_#me_#in_k#m_ely_mel_#fi_ere_fiz_lag_yek_ek#_ail_kai_ag#_ila_ger_lye_k#f	ingerek_melyek_fizikailag
jel_zik_ika_izi_#me_ele_#je_ely_mel_#fi_fiz_lag_yek_ek#_ail_g#j_kai_ag#_ila_lye_len_k#f_en#	melyek_fizikailag_jelen
jel_zik_ika_izi_ak#_ele_#je_n#v_#fi_fiz_lag_ann_ail_#va_g#j_kai_ag#_nak_ila_len_van_nna_en#	fizikailag_jelen_vannak
jel_ann_nak_#je_n#v_#va_az#_k#a_ak#_len_#az_van_nna_ele_en#	jelen_vannak_az
ann_nak_#k#_z#k_#va_az#_k#a_ak#_#az_van_nna	vannak_az_k
#k#_az#_#s#_k#s_#az_z#k	az_k_s
ben_#k#_rle_#s#_let_k#s_tbe_#rl_s#r_en#_etb	k_s_rletben
#v#_ben_rle_n#v_#s#_let_tbe_#rl_s#r_en#_etb	s_rletben_v
lto_#v#_ben_hat_tna_nak_rle_n#v_v#l_let_ozh_tbe_atn_#rl_toz_ak#_#lt_zha_en#_etb	rletben_v_ltozhatnak
oci_zoc_ak#_#v#_tna_cia_iat_k#a_toz_at#_lto_ass_atn_#as_#lt_zha_szo_nak_ssz_v#l_ozh_hat	v_ltozhatnak_asszociat
oci_zoc_ak#_#v#_tna_cia_iat_k#a_toz_at#_lto_ass_atn_#as_#lt_t#v_zha_szo_nak_ssz_ozh_hat	ltozhatnak_asszociat_v
oci_zoc_ssz_#v#_#er_v#e_ass_cia_iat_er#_#as_at#_t#v_szo	asszociat_v_er
#v#_#er_v#e_#ss_er#_r#s_ss#	v_er_ss
#er_#ss_er#_r#s_ss#_s#g_#g#	er_ss_g
g#k_ben_#ss_kbe_#kb_en#_ss#_s#g_#g#	ss_g_kben
g#k_ben_han_n#h_ane_#ha_kbe_#kb_em#_en#_nem_#g#	g_kben_hanem
ben_han_n#h_ane_#az_#ha_kbe_#kb_az#_em#_nem_m#a_en#	kben_hanem_az
oci_zoc_ssz_han_ass_ane_#az_cia_#ha_iat_az#_em#_#as_z#a_nem_m#a_at#_szo	hanem_az_asszociat
oci_zoc_ssz_#v#_ass_cia_iat_az#_#as_z#a_#az_at#_t#v_szo	az_asszociat_v
oci_zoc_ssz_#v#_ass_cia_iat_v#r_#rt_#as_rt#_at#_t#v_szo	asszociat_v_rt
#v#_#ke_ke#_v#r_#rt_rt#_t#k	v_rt_ke
#ke_ke#_#rt_rt#_#is_is#_e#i_t#k	rt_ke_is
#v#_#ke_ke#_s#v_#is_is#_e#i	ke_is_v
lto_#v#_hat_ozt_zta_ath_v#l_s#v_toz_#is_#lt_tat_at#_is#_tha	is_v_ltoztathat
lto_#v#_hat_ozt_zta_ath_v#l_t#a_#a#_toz_tat_#lt_at#_tha	v_ltoztathat_a
lto_hat_#fe_ozt_zta_a#f_ath_fel_t#a_#a#_lt#_toz_tat_#lt_at#_elt_tha	ltoztathat_a_felt
tel_es#_a#f_les_#te_fel_#a#_lt#_#fe_elt_ele_t#t	a_felt_teles
ern_tel_es#_s#i_ek#_les_nge_#te_ger_fel_#in_rne_ing_lt#_nek_#fe_elt_ele_t#t	felt_teles_ingernek
ern_k#e_tel_es#_s#i_#eg_ek#_les_nge_#te_ger_egy_rne_gy#_ing_nek_#in_ele	teles_ingernek_egy
ern_k#e_#eg_els_bel_ls#_ek#_egy_ger_nge_y#b_gy#_rne_ing_nek_#be_#in	ingernek_egy_bels
#eg_ssz_ett_els_bel_ls#_#ss_zet_y#b_egy_tet_s#s_gy#_sze_#be_tt#_ete	egy_bels_sszetett
ssz_ett_els_bel_ls#_#ss_zet_tet_#t#_s#s_sze_#be_tt#_t#t_ete	bels_sszetett_t
ssz_ett_zet_tet_#t#_#ss_rs#_#rs_sze_t#r_tt#_t#t_ete	sszetett_t_rs
#t#_rs#_#rs_t#r_s#t	t_rs_t
#t#_rs#_#rs_#s#_t#s_s#t	rs_t_s
val_#t#_#va_s#v_#s#_t#s_al#	t_s_val
val_el#_#va_Bel_s#v_#s#_al#_#Be_l#B	s_val_Bel
val_el#_#va_Bel_#l#_l#l_al#_#Be_l#B	val_Bel_l
ssz_ett_zet_el#_tet_l#s_#ss_Bel_#l#_l#l_sze_tt#_#Be_ete	Bel_l_sszetett
ssz_ett_zet_tet_#sz_l#s_#ss_sze_sz#_t#s_tt#_#l#_ete	l_sszetett_sz
ssz_ett_zet_tet_#sz_#ss_z#v_ets_#ve_sze_sz#_t#s_vet_tt#_ts#_ete	sszetett_sz_vets
#sz_z#v_ets_#ve_sz#_vet_s#g_ts#_#g#	sz_vets_g
ets_#ve_#j#_g#j_vet_s#g_ts#_#g#	vets_g_j
#n#_j#n_#j#_g#j_#g#	g_j_n
#n#_j#n_#j#_n#l_#l#	j_n_l
#tr_#n#_re#_n#l_l#t_#l#_tre	n_l_tre
#tr_#ha_re#_e#h_l#t_#l#_tre_ha#	l_tre_ha
a#k_#k#_#tr_#ha_re#_e#h_tre_ha#	tre_ha_k
a#k_#k#_#t#_k#t_#ha_ha#	ha_k_t
#k#_#t#_k#t_#CS_t#C_CSt_St#	k_t_CSt
#eg_t#e_#t#_#CS_egy_t#C_gy#_CSt_St#	t_CSt_egy
#tt_#eg_t#e_#CS_egy_gy#_CSt_St#_tt#_y#t	CSt_egy_tt
#tt_#eg_nak_uta_tna_#mu_egy_mut_gy#_atn_ak#_tat_t#m_tt#_y#t	egy_tt_mutatnak
#tt_nak_uta_tna_#mu_mut_be#_atn_ak#_tat_#be_t#m_k#b_tt#	tt_mutatnak_be
nak_uta_tna_#mu_mut_be#_e#a_#a#_atn_ak#_tat_#be_k#b	mutatnak_be_a
a#k_#k#_be#_e#a_#a#_#be	be_a_k
pz#_a#k_#k#_#a#_#pz_k#p	a_k_pz
pz#_#k#_#s#_#pz_k#p_z#s	k_pz_s
or#_pz#_#so_s#s_#s#_sor_#pz_z#s	pz_s_sor
or#_#so_#n#_s#s_#s#_sor_r#n	s_sor_n
or#_ssz_ett_#so_zet_tet_#n#_#ss_n#s_sze_sor_r#n_tt#_ete	sor_n_sszetett
ssz_ett_zet_tet_#n#_#ss_n#s_t#i_nge_ger_sze_er#_ing_#in_tt#_ete	n_sszetett_inger
ssz_ett_zet_tet_#ss_t#i_nge_ger_er#_sze_ing_r#H_#Ha_#in_tt#_Ha#_ete	sszetett_inger_Ha
ger_nge_er#_a#a_az#_ing_r#H_#Ha_#az_#in_Ha#	inger_Ha_az
#eg_egy_ik#_z#e_yik_az#_a#a_#Ha_#az_gyi_Ha#	Ha_az_egyik
#eg_k#k_ns#_kom_omp_egy_ik#_z#e_yik_az#_#ko_mpo_pon_nen_#az_gyi_ens_one	az_egyik_komponens
elt_#eg_k#k_ns#_kom_omp_egy_ik#_yik_nen_#ko_mpo_pon_fel_s#f_lt#_#fe_gyi_ens_one	egyik_komponens_felt
tel_es#_ns#_kom_omp_les_#te_nen_#ko_mpo_pon_fel_s#f_ele_lt#_t#t_#fe_elt_ens_one	komponens_felt_teles
tel_es#_s#i_les_nge_#te_ger_fel_#in_er#_ing_lt#_#fe_elt_ele_t#t	felt_teles_inger
#eg_tel_es#_s#i_les_nge_#te_ger_er#_egy_gye_ing_ed#_r#e_yed_#in_ele	teles_inger_egyed
#eg_d#l_egy_ger_nge_er#_gye_ing_ed#_r#e_yed_#in_#l#	inger_egyed_l
zik_#eg_l#m_uta_#mu_d#l_atk_egy_mut_ik#_gye_ozi_tko_ed#_tat_koz_yed_#l#	egyed_l_mutatkozik
or#_zik_l#m_#ak_uta_akk_#mu_mut_ik#_ozi_kko_tko_k#a_kor_tat_koz_atk_#l#	l_mutatkozik_akkor
or#_zik_akk_#ak_uta_r#a_#mu_mut_ik#_ozi_kor_tko_k#a_zt#_tat_#az_koz_atk_kko_azt	mutatkozik_akkor_azt
or#_ell_akk_#ak_#ke_r#a_ll#_kor_zt#_kel_#az_kko_t#k_azt	akkor_azt_kell
ell_#ke_ll#_fel_zt#_kel_l#f_#az_lt#_#fe_elt_t#k_azt	azt_kell_felt
#ke_tel_ni#_zni_#te_ll#_fel_ezn_kel_lt#_l#f_lez_#fe_elt_ele_t#t_ell	kell_felt_telezni
tel_ni#_i#h_zni_#te_ogy_fel_ezn_#ho_gy#_lt#_hog_lez_#fe_elt_ele_t#t	felt_telezni_hogy
tel_#ak_akt_ni#_i#h_zni_#te_ogy_gy#_#ho_y#a_kti_tiv_iv#_hog_lez_ele_ezn	telezni_hogy_aktiv
#lj_#ak_ja#_akt_ogy_kti_tiv_v#l_gy#_iv#_hog_y#a_#ho_lja	hogy_aktiv_lja
#lj_#ak_akt_kti_tiv_v#l_a#a_#a#_iv#_ja#_lja	aktiv_lja_a
#lj_a#k_#k#_a#a_#a#_ja#_lja	lja_a_k
a#k_#pv_#k#_pvi_vis_ise_#a#_let_et#_k#p_sel_ele	a_k_pviselet
#pv_#k#_vis_pvi_#t#_ise_let_et#_k#p_sel_ele_t#t	k_pviselet_t
#pv_vis_pvi_#t#_ise_t#a_let_#a#_et#_sel_ele_t#t	pviselet_t_a
t#a_#a#_a#t_#t#	t_a_t
bbi_#t#_bi#_a#t_#a#_#bb_t#b	a_t_bbi
or#_bbi_#t#_bi#_#ko_kor_i#k_#bb_t#b	t_bbi_kor
or#_bbi_bba_bi#_r#b_#ko_kor_ban_i#k_an#_#bb	bbi_kor_bban
or#_#p#_bba_r#b_#ko_kor_ban_an#_#bb_n#p	kor_bban_p
#p#_p#r_ros_bba_os#_ban_an#_#bb_n#p_#ro	bban_p_ros
tt#_#p#_p#r_ros_ott_os#_tot_#to_#ro_s#t	p_ros_tott
tt#_ros_ott_t#f_os#_fel_tot_lt#_#to_#fe_elt_#ro_s#t	ros_tott_felt
ott_tel_es#_t#f_les_#te_fel_ele_tot_lt#_#to_#fe_elt_tt#_t#t	tott_felt_teles
tel_es#_s#i_les_nge_#te_ger_fel_#in_er#_ing_lt#_#fe_elt_ele_t#t	felt_teles_inger
tel_es#_s#i_les_nge_#te_ger_er#_ing_r#i_#in_ele_#is_is#	teles_inger_is
#Va_ger_nge_er#_ing_Van_an#_r#i_#in_is#_#is_s#V	inger_is_Van
Ham_mme_#Va_n#H_Van_an#_#Ha_#is_me#_amm_is#_s#V	is_Van_Hamme
Ham_mme_#Va_e#s_#s#_n#H_Van_an#_#Ha_me#_amm	Van_Hamme_s
s#W_Ham_mme_rma_e#s_ass_Was_man_ser_#s#_sse_erm_me#_#Ha_an#_amm_#Wa	Hamme_s_Wasserman
s#W_man_#ja_n#j_sse_jav_vas_Was_erm_olj_ser_ja#_rma_sol_ass_#s#_an#_lja_ava_aso_#Wa	s_Wasserman_javasolja
man_#ja_n#j_sse_jav_vas_Was_#ho_erm_olj_ser_ja#_rma_sol_ass_gy#_#Wa_an#_hog_lja_ava_aso_ogy_a#h	Wasserman_javasolja_hogy
rek_#ja_y#i_nge_ing_jav_#in_vas_olj_ere_ja#_sol_ek#_gy#_a#h_hog_lja_ava_aso_ogy_ger_#ho	javasolja_hogy_ingerek
k#k_#k#_rek_y#i_ek#_ogy_nge_ger_gy#_ing_hog_ere_#in_#ho	hogy_ingerek_k
zve_k#k_#k#_rek_k#z_ek#_ger_nge_tve_ve#_ing_etv_#zv_ere_#in_vet	ingerek_k_zvetve
zve_#k#_k#z_tve_e#a_ve#_#a#_etv_#zv_vet	k_zvetve_a
zve_els_bel_ls#_a#b_tve_e#a_ve#_#a#_etv_#zv_#be_vet	zvetve_a_bels
ssz_ett_els_bel_ls#_#ss_a#b_zet_tet_s#s_sze_#a#_#be_tt#_ete	a_bels_sszetett
ssz_ett_els_bel_ls#_#ss_zet_tet_#t#_s#s_sze_#be_tt#_t#t_ete	bels_sszetett_t
ssz_ett_zet_tet_#t#_#ss_rs#_#rs_sze_t#r_tt#_t#t_ete	sszetett_t_rs
#t#_rs#_#rs_t#r_s#t	t_rs_t
#t#_rs#_#rs_#s#_t#s_s#t	rs_t_s
val_#t#_#va_s#v_#s#_t#s_al#	t_s_val
val_#va_ega_s#v_#s#_#ne_neg_al#_gat_l#n_at#	s_val_negat
val_#v#_#va_ega_#ne_neg_al#_gat_l#n_at#_t#v	val_negat_v
#v#_tan_anu_nul_gat_v#t_ega_ul#_neg_#ne_#ta_at#_t#v	negat_v_tanul
#v#_tan_anu_nul_si#_l#s_v#t_ul#_#si_#ta	v_tanul_si
anu_tan_nul_si#_par_l#s_am#_ul#_ara_#pa_#si_i#p_#ta_ram	tanul_si_param
si#_par_m#t_am#_ter_ert_ara_#te_#pa_#si_i#p_ram_rt#	si_param_tert
m#t_par_nk#_am#_ter_ert_ara_#te_#ka_#pa_unk_ram_rt#_kap_pun_t#k_apu	param_tert_kapunk
k#g_nk#_ter_ert_#te_#ka_unk_gy#_#gy_rt#_kap_pun_t#k_apu	tert_kapunk_gy
k#g_nk#_#ka_unk_gy#_#gy_#a#_kap_y#a_pun_apu	kapunk_gy_a
jel_ens_#je_ns#_gy#_#a#_ele_len_y#a_a#j_#gy	gy_a_jelens
jel_ens_#je_ns#_ek#_s#g_#ge_a#j_gek_#a#_len_ele	a_jelens_gek
jel_ssz_vis_#je_ns#_#vi_ek#_s#g_#ge_sza_zam_gek_k#v_ele_ame_iss_len_men_ens_en#	jelens_gek_visszamen
#le_ssz_leg_es#_vis_#vi_ek#_#ge_sza_zam_ges_k#v_ege_ame_iss_gek_n#l_men_en#	gek_visszamen_leges
#le_ssz_leg_es#_vis_s#j_#vi_ra#_sza_ges_zam_ege_ame_iss_#jr_n#l_men_en#_jra	visszamen_leges_jra
#le_s#j_leg_es#_ra#_ges_ege_a#r_#rt_rt#_#jr_jra	leges_jra_rt
#ke_el#_ra#_#rt_a#r_rt#_kel_#jr_t#k_jra	jra_rt_kel
#ke_el#_l#s_#rt_#s#_rt#_kel_t#k	rt_kel_s
#ke_#t#_el#_l#s_#s#_kel_s#t	kel_s_t
#le_#t#_leh_ehe_#s#_et#_t#l_het_s#t	s_t_lehet
#le_mag_gya_#t#_leh_ar#_ehe_yar_et#_t#l_t#m_het_#ma_agy	t_lehet_magyar
#le_mag_gya_leh_r#z_zni_ni#_ar#_ehe_#zn_yar_et#_t#m_het_#ma_agy	lehet_magyar_zni
mag_gya_i#V_ni#_r#z_zni_egy_ar#_#Ve_gy#_#zn_Veg_yar_#ma_agy	magyar_zni_Vegy
#k#_i#V_y#k_ni#_egy_zni_#Ve_gy#_#zn_Veg	zni_Vegy_k
#k#_y#k_egy_gy#_#Ve_#a#_Veg_k#a	Vegy_k_a
#a#_a#k_k#a_#k#	k_a_k
a#k_#k#_#ve_k#v_#a#_ez#_etk_tke_kez_vet	a_k_vetkez
#p#_#k#_#ve_k#v_ez#_etk_tke_kez_vet_z#p	k_vetkez_p
p#l_#p#_ld#_#ld_#ve_ez#_etk_tke_kez_vet_z#p	vetkez_p_ld
#p#_ld#_#t#_#ld_d#t_p#l	p_ld_t
#eg_t#e_ld#_#t#_#ld_egy_gy#_d#t	ld_t_egy
#eg_t#e_#k#_#t#_y#k_egy_gy#	t_egy_k
#eg_#k#_y#k_egy_gy#_#s#_k#s	egy_k_s
ti#_#k#_rle_eti_#s#_let_k#s_#rl_s#r	k_s_rleti
ti#_par_dig_rle_eti_ara_igm_#pa_#s#_let_rad_#rl_i#p_gm#_s#r_adi	s_rleti_paradigm
ti#_m#t_par_dig_#t#_eti_rle_ara_igm_#pa_let_rad_#rl_i#p_gm#_adi	rleti_paradigm_t
m#t_par_dig_#t#_ara_igm_#pa_t#a_rad_#a#_gm#_adi	paradigm_t_a
#t#_#h#_t#a_#a#_a#h	t_a_h
h#t_#tr_ra#_#h#_tra_#a#_a#h	a_h_tra
h#t_#tr_ra#_#h#_tra_a#z_#z#	h_tra_z
ol#_rol_#tr_ra#_a#z_tra_z#r_#z#_#ro	tra_z_rol
ol#_rol_l#s_z#r_#s#_#z#_#ro	z_rol_s
ol#_rol_#t#_l#s_#s#_#ro_s#t	rol_s_t
mi#_ami_#t#_t#a_#s#_#am_s#t	s_t_ami
mi#_jel_ami_#t#_i#j_#je_elz_t#a_#am_zi#_lzi	t_ami_jelzi
mi#_jel_ami_#je_i#j_i#a_elz_#a#_#am_zi#_lzi	ami_jelzi_a
jel_ssz_vis_#je_#vi_i#a_sza_men_zam_elz_#a#_ame_iss_a#v_zi#_lzi_en#	jelzi_a_visszamen
#le_ssz_leg_es#_vis_#vi_sza_ges_zam_#a#_ame_iss_ege_n#l_men_a#v_en#	a_visszamen_leges
#le_ssz_leg_es#_vis_s#j_#vi_ra#_sza_ges_zam_ege_ame_iss_#jr_n#l_men_en#_jra	visszamen_leges_jra
#le_s#j_leg_es#_ra#_ges_ege_a#r_#rt_rt#_#jr_jra	leges_jra_rt
#ke_el#_ra#_#rt_a#r_rt#_kel_#jr_t#k_jra	jra_rt_kel
#ke_el#_l#s_#rt_rt#_kel_#st_st#_t#k	rt_kel_st
ol#_#ke_aho_el#_l#s_t#a_kel_hol_#st_st#_#ah	kel_st_ahol
ol#_aho_l#A_t#a_AB#_#AB_hol_#st_st#_#ah	st_ahol_AB
ol#_B#a_aho_az#_AB#_#AB_hol_#az_l#A_#ah	ahol_AB_az
ssz_B#a_ett_zet_tet_#ss_az#_sze_AB#_#AB_#az_z#s_tt#_ete	AB_az_sszetett
ssz_ett_zet_tet_#ss_t#i_nge_ger_er#_az#_sze_ing_#az_z#s_#in_tt#_ete	az_sszetett_inger
ssz_ett_zet_tet_r#A_#ss_t#i_nge_ger_er#_sze_ing_#A#_#in_tt#_ete	sszetett_inger_A
r#A_ger_nge_er#_A#B_ing_#A#_#B#_#in	inger_A_B
#f#_A#B_B#f_#A#_#B#	A_B_f
f#z_#f#_#zi_B#f_#B#_zis_is#	B_f_zis
f#z_#f#_#zi_AB#_#AB_s#A_zis_is#	f_zis_AB
US#_#US_#zi_AB#_#AB_s#A_B#U_zis_is#	zis_AB_US
US#_#f#_#US_S#f_B#U_AB#_#AB	AB_US_f
US#_f#z_#f#_#US_S#f_#zi_zis_is#	US_f_zis
f#z_#f#_#zi_s#A_#A#_zis_is#	f_zis_A
US#_#US_#zi_A#U_#A#_s#A_zis_is#	zis_A_US
US#_#US_A#U_#A#_S#K_#K#	A_US_K
US#_#US_K#s_#s#_S#K_#K#	US_K_s
rle_ek#_#s#_K#s_let_#rl_s#r_#K#_tek_ete	K_s_rletek
#cs_k#c_rle_ek#_cso_sop_por_#s#_let_#rl_ort_rt#_s#r_opo_tek_ete	s_rletek_csoport
#cs_k#c_rle_ek#_cso_sop_por_ely_t#a_let_ame_mel_ly#_#rl_ort_rt#_#am_opo_tek_ete	rletek_csoport_amely
y#m_por_#me_pta_sop_cso_ely_ame_mel_kap_#am_opo_ort_ly#_egk_meg_ta#_gka_apt_#cs_t#a_rt#	csoport_amely_megkapta
y#m_gka_apt_pta_ely_a#a_az#_ame_mel_ly#_egk_#am_kap_#az_meg_#me_ta#	amely_megkapta_az
gka_apt_pta_z#s_a#a_az#_#s#_egk_kap_#az_meg_#me_ta#	megkapta_az_s
#f#_az#_#s#_s#f_#az_z#s	az_s_f
f#z_#f#_#zi_#s#_s#f_zis_is#	s_f_zis
f#z_#t#_#f#_#zi_zis_is#_s#t	f_zis_t
#t#_#zi_t#a_#a#_zis_is#_s#t	zis_t_a
a#k_#k#_#t#_t#a_#a#	t_a_k
a#k_#k#_#s#_#a#_k#s	a_k_s
#k#_etn_rle_ek#_#s#_let_k#s_#rl_nek_s#r_tne	k_s_rletnek
k#g_etn_rle_ek#_eng_ng#_gye_#s#_let_#rl_nek_yen_s#r_tne_#gy	s_rletnek_gyeng
k#g_etn_rle_ek#_ng#_gye_bb#_let_#rl_nek_yen_eng_g#b_#bb_tne_#gy	rletnek_gyeng_bb
cio_b#k_dic_ond_ici_ng#_gye_bb#_#ko_kon_g#b_on#_eng_#bb_ndi_yen_#gy_ion	gyeng_bb_kondicion
cio_b#k_n#l_ond_ici_#lt_#ko_bb#_lt#_on#_kon_#bb_ndi_dic_ion	bb_kondicion_lt
cio_#v#_n#l_ond_ici_#ko_lt#_on#_kon_dic_ndi_#lt_t#v_ion	kondicion_lt_v
#v#_#la_asz_las_v#l_szt_lt#_zt#_#lt_t#v	lt_v_laszt
#v#_#la_asz_uta_las_#mu_mut_v#l_szt_zt#_tat_at#_t#m	v_laszt_mutat
#la_asz_uta_las_#mu_CR#_mut_t#C_szt_zt#_tat_at#_t#m_#CR	laszt_mutat_CR
uta_CR#_#mu_mut_t#C_#a#_R#a_tat_at#_#CR	mutat_CR_a
CR#_#a#_R#a_#B#_a#B_#CR	CR_a_B
#mi_B#m_int_min_#a#_nt#_#B#_a#B	a_B_mint
#mi_B#m_int_min_t#a_#a#_nt#_#B#	B_mint_a
#mi_rol_a#k_int_ont_min_#ko_t#a_#a#_ll#_nt#_kon_tro_oll_ntr	mint_a_kontroll
rol_a#k_#cs_l#c_ont_cso_sop_#ko_ll#_#a#_opo_por_rt#_kon_tro_oll_ntr_ort	a_kontroll_csoport
por_cso_sop_ely_#ko_ame_mel_#am_opo_oll_ort_l#c_ly#_kon_tro_rol_#cs_ll#_t#a_rt#_ont_ntr	kontroll_csoport_amely
#cs_sop_cso_y#c_por_ely_t#a_csa_ame_mel_ly#_rt#_#am_sak_ak#_opo_ort	csoport_amely_csak
#cs_y#c_csa_ely_sak_az#_ame_mel_ly#_ak#_#am_k#a_#az	amely_csak_az
#cs_z#f_#f#_csa_az#_sak_k#a_ak#_#az	csak_az_f
f#z_z#f_#f#_az#_#zi_#az_zis_is#	az_f_zis
f#z_#t#_#f#_#zi_zis_is#_s#t	f_zis_t
ta#_apt_#t#_pta_#ka_#zi_t#k_kap_zis_is#_s#t	zis_t_kapta
apt_#t#_#Az_pta_Az#_#ka_kap_ta#_t#k_a#A	t_kapta_Az
red_det_apt_#er_ede_#Az_Az#_pta_eti_ti#_#ka_z#e_kap_ere_ta#_a#A	kapta_Az_eredeti
red_det_#er_ede_ti#_Az#_#Az_#RW_eti_z#e_i#R_ere_RW#	Az_eredeti_RW
red_det_#er_ede_ti#_#RW_ode_eti_lje_je#_#mo_llj_del_W#m_mod_i#R_ere_ell_RW#	eredeti_RW_modellje
#RW_ode_lje_je#_#mo_llj_del_em#_#ne_mod_W#m_nem_e#n_ell_RW#	RW_modellje_nem
m#t_ode_#tu_ja#_lje_je#_#mo_llj_tud_del_em#_#ne_udj_dja_mod_nem_e#n_ell	modellje_nem_tudja
dok_oko_m#t_#tu_kol_ind_ni#_tud_udj_em#_#ne_dja_#in_ndo_oln_lni_nem_ja#_a#i	nem_tudja_indokolni
dok_#ez_oko_#tu_kol_ezt_ind_ni#_tud_i#e_udj_#in_dja_oln_ndo_lni_zt#_ja#_a#i	tudja_indokolni_ezt
dok_#ez_oko_kol_ezt_ind_ni#_i#e_t#a_#a#_oln_ndo_lni_zt#_#in	indokolni_ezt_a
#ez_ezt_#ha_t#a_#a#_zt#_hat_at#_a#h	ezt_a_hat
#st_#ha_#a#_t#s_hat_at#_a#h_st#	a_hat_st
#st_#ha_#de_de#_t#s_hat_at#_t#d_st#	hat_st_de
#de_az#_e#a_de#_#az_#st_t#d_st#	st_de_az
lgo_tt#_ott_ozo_tdo_#de_az#_e#a_zot_dol_z#t_goz_#az_olg_de#_#td	de_az_tdolgozott
lgo_tt#_ott_ozo_ode_#mo_az#_zot_del_dol_ll#_z#t_goz_mod_#az_t#m_olg_tdo_ell_#td	az_tdolgozott_modell
gen_#mo_l#i_del_t#m_olg_ott_mod_#ig_ell_lgo_ozo_ode_tdo_goz_ige_#td_dol_ll#_zot_tt#_en#	tdolgozott_modell_igen
#ig_ige_gen_ode_#mo_ll#_del_l#i_en#_mod_n#A_#A#_ell	modell_igen_A
gen_#ig_A#f_#f#_en#_#A#_n#A_ige	igen_A_f
f#z_A#f_#f#_#zi_ban_isb_sba_an#_#A#_zis	A_f_zisban
f#z_n#a_#f#_#zi_az#_ban_isb_sba_an#_#az_zis	f_zisban_az
#sz_n#a_#zi_az#_ban_szt_isb_sba_an#_zt#_#az_zis_z#s	zisban_az_szt
nz#_t#n_#sz_szt_az#_zt#_#az_z#s_#nz	az_szt_nz
z#B_nz#_t#n_#sz_szt_zt#_#B#_#nz	szt_nz_B
z#B_nz#_#k#_#B#_B#k_#nz	nz_B_k
zve_#k#_k#z_etv_tve_ve#_#B#_#zv_vet_B#k	B_k_zvetve
zve_#ak_#k#_k#z_akt_kti_tiv_tve_e#a_ve#_iv#_etv_#zv_vet	k_zvetve_aktiv
zve_#ak_akt_kti_tiv_v#l_tve_e#a_ve#_iv#_etv_#zv_vet_#l#	zvetve_aktiv_l
#ak_ott_akt_l#d_kti_tiv_v#l_iv#_dot_#do_tt#_#l#	aktiv_l_dott
ott_l#d_az#_t#a_dot_#do_#az_tt#_#l#	l_dott_az
ott_az#_t#a_dot_#do_#A#_#az_tt#_z#A	dott_az_A
els_bel_ls#_az#_#A#_#az_#be_A#b_z#A	az_A_bels
ssz_ett_els_bel_ls#_#ss_zet_tet_s#s_sze_#A#_#be_A#b_tt#_ete	A_bels_sszetett
ssz_ett_els_bel_ls#_#ss_zet_tet_#t#_s#s_sze_#be_tt#_t#t_ete	bels_sszetett_t
ssz_ett_zet_tet_#t#_#ss_rs#_#rs_sze_t#r_tt#_t#t_ete	sszetett_t_rs
#t#_rs#_#rs_t#r_s#t	t_rs_t
#t#_rs#_#rs_#s#_t#s_s#t	rs_t_s
val_#t#_#va_s#v_#s#_t#s_al#	t_s_val
val_l#D_De#_#va_s#v_#s#_#De_al#	s_val_De
val_yet_l#D_hel_ett_De#_ahe_#va_ely_e#a_lye_#De_al#_tt#_#ah	val_De_ahelyett
yet_hel_ett_De#_ahe_ogy_ely_e#a_lye_#De_t#h_#ho_gy#_hog_tt#_#ah	De_ahelyett_hogy
yet_hel_ett_ahe_ogy_ely_#ho_lye_gy#_t#h_#a#_hog_y#a_tt#_#ah	ahelyett_hogy_a
zit_a#p_ogy_it#_poz_gy#_#po_#a#_ozi_hog_y#a_#ho	hogy_a_pozit
zit_a#p_#v#_it#_#po_#a#_ozi_poz_t#v	a_pozit_v
zit_#v#_tan_anu_nul_v#t_it#_ul#_#po_ozi_#ta_poz_t#v	pozit_v_tanul
#v#_tan_anu_nul_si#_l#s_v#t_ul#_#si_#ta	v_tanul_si
anu_tan_nul_si#_par_l#s_am#_ul#_ara_#pa_#si_i#p_#ta_ram	tanul_si_param
si#_par_m#t_am#_ter_ert_ara_#te_#pa_#si_i#p_ram_rt#	si_param_tert
m#t_par_am#_ter_ert_ara_#te_tal_#pa_ram_rt#_al#_t#l_#lt_lta	param_tert_ltal
l#b_ter_ert_#te_tal_ban_rt#_#ba_al#_t#l_an#_#lt_lta	tert_ltal_ban
l#b_n#a_#az_tal_az#_ban_#ba_an#_al#_#lt_lta	ltal_ban_az
alf_n#a_lfa_az#_fa#_ban_an#_#ba_z#a_#az_#al	ban_az_alfa
or#_alf_ami_lfa_iko_az#_fa#_a#a_kor_mik_#al_z#a_#am_#az	az_alfa_amikor
zik_ami_ika_izi_iko_a#a_mik_alf_r#f_kor_#am_#fi_fiz_or#_lag_lfa_ail_#al_kai_ag#_ila_fa#	alfa_amikor_fizikailag
jel_zik_ami_ika_izi_iko_mik_ele_r#f_#je_kor_#am_#fi_fiz_or#_lag_ail_g#j_kai_ag#_ila_len_en#	amikor_fizikailag_jelen
jel_zik_lag_ika_#je_ila_izi_ail_n#v_#va_en#_len_g#j_an#_#fi_van_kai_ele_fiz_ag#	fizikailag_jelen_van
jel_#je_n#a_n#v_#va_#a#_an#_len_van_ele_en#	jelen_van_a
n#a_#f#_a#f_#va_#a#_an#_van	van_a_f
f#z_#f#_a#f_#zi_#a#_ban_isb_sba_an#_zis	a_f_zisban
f#z_#f#_#zi_ban_isb_sba_an#_n#B_zis_#B#	f_zisban_B
B#n_ek#_#zi_ban_#ne_isb_sba_an#_nek_n#B_zis_#B#	zisban_B_nek
B#n_ek#_ega_#ne_neg_nek_#B#_gat_at#_k#n	B_nek_negat
#v#_ek#_ega_neg_#ne_nek_gat_at#_t#v_k#n	nek_negat_v
#v#_tan_anu_nul_gat_v#t_ega_ul#_neg_#ne_#ta_at#_t#v	negat_v_tanul
#v#_tan_anu_nul_si#_l#s_v#t_ul#_#si_#ta	v_tanul_si
anu_tan_nul_si#_par_l#s_am#_ul#_ara_#pa_#si_i#p_#ta_ram	tanul_si_param
si#_par_m#t_am#_ter_ara_#te_#pa_re#_#si_i#p_ram_ere	si_param_tere
m#t_par_e#v_am#_ter_#va_ara_#te_#pa_re#_ram_van_an#_ere	param_tere_van
n#g_e#v_ter_#va_#te_gy#_re#_an#_van_ere_#gy	tere_van_gy
n#g_#va_gy#_#a#_an#_van_y#a_#gy	van_gy_a
#m#_a#m_gy#_#a#_y#a_#gy	gy_a_m
#so_#m#_m#s_a#m_ik#_#a#_sod_dik_odi	a_m_sodik
#so_#m#_m#s_#f#_ik#_sod_k#f_dik_odi	m_sodik_f
f#z_#so_#f#_ik#_zis_#zi_sod_k#f_is#_dik_odi	sodik_f_zis
f#z_#f#_#zi_#B#_zis_is#_s#B	f_zis_B
oci_zoc_ssz_B#a_ass_cia_iat_#zi_#as_#B#_at#_zis_is#_s#B_szo	zis_B_asszociat
oci_zoc_ssz_B#a_#v#_ass_cia_iat_#as_#B#_at#_t#v_szo	B_asszociat_v
oci_zoc_ssz_#v#_#er_v#e_ass_cia_eje_iat_je#_#as_rej_at#_ere_t#v_szo	asszociat_v_ereje
#v#_#er_#cs_v#e_eje_je#_rej_ere_cs#_e#c	v_ereje_cs
#er_#cs_eje_#kk_je#_ken_s#k_rej_kke_ere_cs#_e#c_en#	ereje_cs_kken
#cs_#kk_n#a_ken_az#_s#k_kke_#az_cs#_en#	cs_kken_az
n#a_#kk_az#_kke_#A#_#az_ken_en#_z#A	kken_az_A
A#r_az#_#rt_rt#_#A#_#az_z#A	az_A_rt
#ke_ke#_A#r_#rt_rt#_#A#_t#k	A_rt_ke
isz_#ke_e#v_vis_#vi_ke#_zon_#rt_nt#_rt#_ont_szo_t#k	rt_ke_viszont
isz_#ke_t#n_vis_e#v_#vi_ke#_#n#_zon_nt#_ont_szo	ke_viszont_n
isz_t#n_vis_n#a_#vi_#n#_zon_#a#_nt#_ont_szo	viszont_n_a
zit_a#p_n#a_#n#_it#_#po_#a#_ozi_poz	n_a_pozit
zit_a#p_#v#_it#_#po_#a#_ozi_poz_t#v	a_pozit_v
zit_#v#_tan_anu_nul_v#t_it#_ul#_#po_ozi_#ta_poz_t#v	pozit_v_tanul
#v#_tan_anu_nul_si#_l#s_v#t_ul#_#si_#ta	v_tanul_si
anu_tan_nul_si#_par_l#s_am#_ul#_ara_#pa_#si_i#p_#ta_ram	tanul_si_param
si#_par_m#t_am#_ter_ara_#te_#pa_re#_#si_i#p_ram_ere	si_param_tere
#mi_tt#_m#t_par_am#_ter_iat_ara_#te_att_#pa_re#_ram_mia_ere_e#m	param_tere_miatt
#mi_t#g_tt#_ter_iat_#te_att_gy#_re#_mia_ere_e#m_#gy	tere_miatt_gy
#mi_t#g_att_iat_gy#_#a#_mia_y#a_tt#_#gy	miatt_gy_a
el#_a#f_gy#_fel_#a#_#fe_y#a_#gy	gy_a_fel
el#_a#f_fel_#a#_#j#_l#j_#fe	a_fel_j
ott_el#_j#t_fel_#j#_tot_#to_l#j_#fe_tt#	fel_j_tott
ott_#RW_t#R_j#t_#j#_tot_#to_tt#_RW#	j_tott_RW
ott_#RW_ode_t#R_#mo_ll#_del_tot_W#m_#to_mod_tt#_ell_RW#	tott_RW_modell
mag_l#m_#RW_ode_gya_agy_#mo_ar#_ll#_del_yar_mod_W#m_#ma_ell_RW#	RW_modell_magyar
mag_l#m_gya_ode_#zz_r#z_agy_#mo_ar#_ll#_del_za#_yar_mod_#ma_ell_zza	modell_magyar_zza
mag_gya_#zz_r#z_za#_ogy_ar#_gy#_#ho_yar_hog_a#h_#ma_agy_zza	magyar_zza_hogy
#zz_ogy_gy#_a#h_#a#_hog_y#a_#ho_za#_zza	zza_hogy_a
CR#_a#C_ogy_gy#_#a#_hog_y#a_#ho_#CR	hogy_a_CR
ami_CR#_it#_#a#_R#a_mit_#am_a#C_#CR	a_CR_amit
ami_CR#_it#_t#a_mit_R#a_#a#_#am_#CR	CR_amit_a
ami_it#_t#a_mit_#a#_#am_#B#_a#B	amit_a_B
#ki_kiv_#a#_iv#_#B#_a#B_B#k	a_B_kiv
lto_tt#_ott_#ki_v#l_kiv_iv#_tot_#B#_#lt_B#k	B_kiv_ltott
lto_ott_#ki_v#l_kiv_t#a_iv#_#a#_tot_#lt_tt#	kiv_ltott_a
lto_ssz_ott_vis_el#_#vi_sza_zaf_fel_t#a_#a#_afe_iss_tot_#lt_tt#_a#v	ltott_a_visszafel
ol#_l#b_ssz_blo_lok_vis_el#_#vi_kol_sza_zaf_fel_#bl_#a#_afe_iss_okk_kko_a#v	a_visszafel_blokkol
ol#_l#b_ssz_blo_lok_vis_el#_#vi_kol_l#k_sza_#k#_zaf_fel_#bl_afe_iss_okk_kko	visszafel_blokkol_k
ol#_pz#_blo_lok_l#k_#k#_kol_#bl_okk_#pz_k#p_kko	blokkol_k_pz
pz#_#k#_#s#_#pz_k#p_z#s	k_pz_s
pz#_#s#_s#u_#pz_#ut_ut#_z#s	pz_s_ut
t#n_#n#_#s#_s#u_#ut_ut#	s_ut_n
#mi_mi#_t#n_n#m_#n#_#ut_ut#	ut_n_mi
#mi_mi#_n#m_#n#_i#r_#rt_rt#	n_mi_rt
#mi_mi#_t#g_i#r_ng#_gye_#rt_rt#_eng_yen_#gy	mi_rt_gyeng
t#g_ng#_gye_bb#_#rt_rt#_g#b_eng_#bb_yen_#gy	rt_gyeng_bb
#mi_b#m_int_ng#_gye_bb#_min_nt#_g#b_eng_#bb_yen_#gy	gyeng_bb_mint
#mi_b#m_int_min_bb#_t#a_az#_nt#_#az_#bb	bb_mint_az
#mi_int_min_az#_t#a_nt#_AB#_#AB_#az_z#A	mint_az_AB
#cs_B#c_csa_az#_sak_AB#_#AB_ak#_#az_z#A	az_AB_csak
cio_#cs_k#k_ond_B#c_ici_csa_#ko_sak_AB#_#AB_ak#_on#_kon_dic_ndi_ion	AB_csak_kondicion
cio_#cs_k#k_n#l_ond_ici_csa_#ko_sak_ak#_on#_kon_dic_ndi_#l#_ion	csak_kondicion_l
cio_l#N_n#l_ond_ici_#N#_#ko_on#_kon_dic_ndi_#l#_ion	kondicion_l_N
l#N_N#h_#N#_#h#_#l#	l_N_h
N#h_#N#_#h#_ny#_#ny_h#n	N_h_ny
ba#_#h#_ny#_hib_iba_#hi_y#h_#ny_h#n	h_ny_hiba
ba#_hib_ny#_a#a_iba_#a#_#hi_y#h_#ny	ny_hiba_a
cor_orl_a#R_esc_hib_a#a_#hi_iba_#a#_#Re_Res_rla_ba#_la#_sco	hiba_a_Rescorla
orl_a#W_a#R_esc_Wag_agn_ner_er#_la#_#a#_Res_#Re_rla_cor_gne_#Wa_sco	a_Rescorla_Wagner
ner_Wag_#mo_del_rla_sco_orl_esc_er#_mod_cor_ell_llb_ben_a#W_ode_agn_lbe_la#_r#m_Res_#Re_gne_#Wa_en#	Rescorla_Wagner_modellben
#sz_ner_Wag_#mo_sze_del_esz_er#_kes_zer_zt#_mod_ell_llb_ben_ode_agn_n#s_erk_lbe_r#m_rke_szt_gne_#Wa_en#	Wagner_modellben_szerkeszt
#sz_#mo_sze_del_esz_kes_zer_zt#_mod_ell_llb_ben_ode_n#s_erk_lbe_#s#_t#s_rke_szt_en#	modellben_szerkeszt_s
#Sp_#sz_rke_erk_s#S_kes_sze_esz_szt_#s#_zer_t#s_zt#_Spo_pon_ont_nt#	szerkeszt_s_Spont
#Sp_t#n_#n#_s#S_pon_#s#_nt#_Spo_ont	s_Spont_n
#Sp_t#n_n#f_el#_#n#_fel_pon_nt#_Spo_ont_#fe	Spont_n_fel
#p#_n#f_el#_#n#_fel_#fe_l#p	n_fel_p
#p#_el#_fel_#fe_p#l_l#p_#l#	fel_p_l
#p#_l#s_#s#_p#l_#l#	p_l_s
s#a_l#s_#s#_#a#_#l#	l_s_a
a#k_s#a_hal_#ki_#a#_#s#_kih_al#_iha	s_a_kihal
a#k_hal_#ki_l#s_#a#_kih_al#_#sb_sb#_iha	a_kihal_sb
hal_#ki_l#s_#l#_kih_b#l_al#_#sb_sb#_iha	kihal_sb_l
l#a_ami_it#_mit_b#l_sb#_#sb_#am_#l#	sb_l_amit
l#a_ami_it#_az#_t#a_mit_#am_#az_#l#	l_amit_az
eml_ami_ml#_#em_it#_z#e_az#_t#a_mit_#am_#az	amit_az_eml
eml_ml#_l#k_#ke_zte_tet_ezt_#em_z#e_az#_et#_#az_kez	az_eml_keztet
ml#_#ke_l#k_zte_tet_ezt_t#j_#em_#jb_jb#_et#_eml_kez	eml_keztet_jb
#ke_zte_tet_t#j_#li_ezt_li#_#jb_jb#_et#_b#l_kez	keztet_jb_li
#ke_#li_el#_li#_eze_#jb_i#k_jb#_b#l_zel_kez	jb_li_kezel
#ke_#se_#li_el#_l#s_ek#_li#_eze_sek_i#k_zel_kez	li_kezel_sek
tak_k#o_#ke_#se_oko_el#_ozt_l#s_ek#_sek_eze_zta_#ok_ak#_zel_koz_kez	kezel_sek_okoztak
tak_k#o_oko_#se_ozt_k#J_zta_ek#_sek_#ok_#J#_ak#_koz	sek_okoztak_J
tak_oko_ozt_k#J_zta_#ok_#J#_J#l_ak#_koz_#l#	okoztak_J_l
l#m_ott_ala_ozo_apo_ega_poz_gal_zot_#J#_J#l_lap_meg_#me_tt#_#l#	J_l_megalapozott
zre_l#m_ott_ala_ozo_apo_#sz_ev#_ega_poz_gal_zot_t#s_szr_lap_rev_meg_#me_tt#_#l#	l_megalapozott_szrev
ala_#sz_apo_ev#_#me_tt#_ott_el#_ega_#te_zre_ozo_gal_t#s_szr_meg_poz_tel_v#t_zot_lap_rev	megalapozott_szrev_tel
tel_#sz_el#_ev#_v#t_ogy_#te_gy#_#ho_szr_hog_l#h_zre_rev	szrev_tel_hogy
tel_el#_ogy_#te_gy#_#a#_hog_l#h_y#a_#ho	tel_hogy_a
ogy_a#t_tim_#ti_gy#_#a#_me#_hog_ime_y#a_#ho	hogy_a_time
e#o_tim_a#t_#ti_#a#_ut#_me#_ime_out_#ou	a_time_out
val_erv_lum_rva_e#o_t#i_int_tim_ter_#ti_llu_um#_all_nte_ut#_me#_ime_#in_out_#ou	time_out_intervallum
erv_t#i_all_#in_eje_fej_efe_#ou_out_m#b_int_nte_ut#_#be_lum_val_rva_ter_um#_llu_ez#_bef_jez	out_intervallum_befejez
erv_all_#in_eje_fej_efe_m#b_int_#s#_nte_#be_lum_val_rva_ter_um#_llu_ez#_bef_jez_z#s	intervallum_befejez_s
#t#_eje_fej_s#t_efe_#s#_ez#_bef_jez_#be_z#s	befejez_s_t
#k#_#t#_s#t_#s#_t#k	s_t_k
#k#_#t#_#ve_k#v_et#_vet_t#k	t_k_vet
t#e_#k#_#en_#ve_k#v_et#_vet_en#	k_vet_en
#en_t#e_n#a_#ve_#a#_et#_vet_en#	vet_en_a
a#k_#en_hal_n#a_#ki_#a#_kih_al#_iha_en#	en_a_kihal
a#k_hal_#ki_l#s_#a#_#s#_kih_al#_iha	a_kihal_s
hal_#ki_l#s_#r#_#s#_kih_al#_s#r_iha	kihal_s_r
leg_es#_#sz_#r#_szl_ges_zle_#s#_ege_r#s_s#r	s_r_szleges
leg_es#_#sz_el#_#r#_szl_ges_zle_fel_ege_s#f_r#s_#fe	r_szleges_fel
#p#_leg_es#_#sz_el#_szl_ges_zle_fel_ege_s#f_#fe_l#p	szleges_fel_p
#p#_el#_fel_#fe_p#l_l#p_#l#	fel_p_l
#p#_l#s_#st_st#_p#l_#l#	p_l_st
red_edm_#er_t#e_dm#_ere_l#s_st#_#st_#l#	l_st_eredm
red_edm_#er_t#e_dm#_yez_#ny_#st_ez#_m#n_ere_st#_nye	st_eredm_nyez
red_edm_#er_dm#_yez_#ny_#a#_ez#_z#a_m#n_ere_nye	eredm_nyez_a
a#k_hal_#ki_yez_#a#_ez#_kih_z#a_al#_#ny_iha_nye	nyez_a_kihal
a#k_hal_#ki_l#s_#a#_kih_al#_#sb_sb#_iha	a_kihal_sb
hal_#ki_l#s_#l#_kih_b#l_al#_#sb_sb#_iha	kihal_sb_l
l#a_#az_az#_zaz_b#l_sb#_#sb_aza_#l#	sb_l_azaz
l#a_az#_zaz_#a#_z#a_#az_aza_#l#	l_azaz_a
or#_a#k_az#_zaz_#a#_#ko_kor_z#a_#az_aza	azaz_a_kor
or#_a#k_bba_r#b_#ko_#a#_kor_ban_an#_#bb	a_kor_bban
or#_gsz_bba_n#m_r#b_egs_#ko_sz#_kor_ban_an#_#bb_meg_#me	kor_bban_megsz
gsz_bba_n#m_z#n_#nt_egs_sz#_ban_nt#_an#_#bb_meg_#me	bban_megsz_nt
gsz_z#n_#nt_rea_egs_sz#_eak_t#r_nt#_ci#_kci_meg_#me_#re_akc	megsz_nt_reakci
i#v_#nt_rea_#va_vag_gy#_eak_t#r_nt#_ci#_kci_#re_akc_agy	nt_reakci_vagy
#v#_i#v_rea_#va_vag_gy#_eak_ci#_y#v_kci_#re_akc_agy	reakci_vagy_v
#v#_#la_asz_las_#va_vag_agy_gy#_v#l_sz#_y#v	vagy_v_lasz
#v#_#la_asz_ssz_las_vis_#vi_z#v_sza_v#l_sz#_iss_at#_zat	v_lasz_visszat
#la_ssz_asz_las_vis_#vi_z#v_#r#_sza_sz#_t#r_iss_at#_zat	lasz_visszat_r
ssz_vis_#vi_#r#_r#d_sza_#de_t#r_iss_at#_de#_zat	visszat_r_de
#r#_r#d_tal_#de_e#l_al#_#lt_de#_lta	r_de_ltal
l#b_tal_#de_ban_e#l_#ba_al#_#lt_an#_de#_lta	de_ltal_ban
lac_l#b_ala_n#a_son_tal_cso_bb#_ban_acs_abb_ony_#ba_an#_al#_#lt_#al_nya_yab_lta	ltal_ban_alacsonyabb
ala_#sz_lac_son_n#a_cso_szi_ony_bb#_zin_b#s_int_abb_nte_#al_an#_acs_ten_ban_#ba_nya_yab_en#	ban_alacsonyabb_szinten
ala_#sz_n#m_nt#_lac_son_cso_min_szi_ony_bb#_zin_b#s_int_abb_nte_#al_acs_ten_#mi_nya_yab_en#	alacsonyabb_szinten_mint
#mi_#sz_n#m_int_min_t#a_#a#_szi_nte_nt#_zin_ten_en#	szinten_mint_a
#mi_a#k_hal_#ki_int_min_t#a_#a#_nt#_kih_al#_iha	mint_a_kihal
a#k_hal_#ki_l#s_#a#_#s#_kih_al#_iha	a_kihal_s
hal_#k#_#ki_l#s_s#k_#s#_kih_al#_iha	kihal_s_k
pz#_#k#_s#k_#s#_#pz_k#p	s_k_pz
pz#_#k#_#se_#pz_se#_k#p_z#s	k_pz_se
pz#_#se_el#_#el_#pz_e#e_se#_z#s	pz_se_el
#tt_#se_el#_#el_e#e_se#_l#t_tt#	se_el_tt
#tt_#Ez_t#E_Ez#_el#_#el_l#t_tt#	el_tt_Ez
#tt_#Ez_t#E_Ez#_#a#_z#a_tt#	tt_Ez_a
jel_ens_#Ez_Ez#_#je_ns#_#a#_ele_z#a_len_a#j	Ez_a_jelens
jel_ens_#je_ns#_s#g_a#j_#a#_len_ele_#g#	a_jelens_g
jel_rra_g#a_#je_ns#_ra#_s#g_arr_ele_#ar_len_ens_#g#	jelens_g_arra
a#u_rra_uta_g#a_ra#_tal_arr_#ar_#ut_al#_#g#	g_arra_utal
a#u_rra_uta_ra#_tal_hog_ogy_arr_gy#_#ar_#ut_al#_l#h_#ho	arra_utal_hogy
uta_tal_hog_ogy_gy#_#a#_#ut_al#_l#h_y#a_#ho	utal_hogy_a
US#_a#U_ogy_#US_gy#_#a#_hog_y#a_#ho	hogy_a_US
S#k_ite_US#_ett_a#U_tet_#ki_#US_#a#_tts_kit_ts#	a_US_kitetts
S#k_ite_US#_ett_tet_#ki_#US_#ge_tts_ge#_kit_s#g_ts#	US_kitetts_ge
#cs_ett_tet_e#c_#ki_#ge_csa_kit_sak_ak#_tts_ge#_ite_s#g_ts#	kitetts_ge_csak
#cs_#ge_csa_sak_#a#_k#a_ak#_ge#_e#c	ge_csak_a
a#k_#cs_#k#_csa_sak_#a#_k#a_ak#	csak_a_k
pz#_a#k_#k#_#a#_#pz_k#p	a_k_pz
pz#_#k#_#st_#pz_k#p_z#s_st#	k_pz_st
pz#_#st_#l#_#pz_t#l_z#s_st#	pz_st_l
l#a_#l#_#a#_t#l_#st_st#	st_l_a
a#k_l#a_hal_#ki_iha_#a#_kih_al#_#l#	l_a_kihal
a#k_hal_#ki_l#s_#a#_#s#_kih_al#_iha	a_kihal_s
hal_eje_#ki_l#s_fej_#s#_efe_ez#_kih_s#b_bef_al#_jez_#be_iha	kihal_s_befejez
#se_eje_fej_#s#_efe_ez#_s#b_bef_jez_se#_#be_z#s	s_befejez_se
e#u_#se_eje_fej_efe_ez#_#ut_bef_jez_se#_ut#_#be_z#s	befejez_se_ut
e#u_t#n_#se_#n#_#ut_ut#_se#	se_ut_n
t#n_#r#_#n#_n#r_#ut_ut#	ut_n_r
leg_es#_#sz_#r#_#n#_szl_ges_n#r_zle_ege_r#s	n_r_szleges
leg_es#_#sz_el#_#r#_szl_ges_zle_fel_ege_s#f_r#s_#fe	r_szleges_fel
#p#_leg_es#_#sz_el#_szl_ges_zle_fel_ege_s#f_#fe_l#p	szleges_fel_p
#p#_el#_fel_#fe_p#l_l#p_#l#	fel_p_l
#p#_l#s_#st_st#_p#l_#l#	p_l_st
oko_l#s_t#o_#ok_st#_koz_#st_oz#_#l#	l_st_okoz
oko_t#o_#ok_#a#_z#a_koz_#st_oz#_st#	st_okoz_a
a#k_oko_hal_#ki_#ok_#a#_kih_z#a_al#_koz_oz#_iha	okoz_a_kihal
a#k_hal_#ki_l#s_#a#_kih_st#_al#_#st_iha	a_kihal_st
hal_#ki_l#s_#l#_kih_st#_al#_t#l_#st_iha	kihal_st_l
#Az_Az#_#l#_st#_t#l_#st_l#A	st_l_Az
#RW_Az#_#Az_z#R_#l#_l#A_RW#	l_Az_RW
#RW_Az#_#Az_z#R_ode_#mo_ll#_del_W#m_mod_ell_RW#	Az_RW_modell
#RW_ode_#mo_ll#_del_em#_#ne_mod_W#m_nem_l#n_ell_RW#	RW_modell_nem
m#t_ode_#tu_#mo_tud_ll#_del_em#_#ne_udj_dja_mod_nem_l#n_ja#_ell	modell_nem_tudja
dok_oko_m#t_#tu_kol_ind_ni#_tud_udj_em#_#ne_dja_#in_ndo_oln_lni_nem_ja#_a#i	nem_tudja_indokolni
#ez_ind_ni#_zek_tud_i#e_#in_ndo_dja_oln_eke_et#_ja#_a#i_dok_#tu_kol_eze_udj_oko_lni_ket	tudja_indokolni_ezeket
dok_#ez_oko_kol_ind_ni#_eze_zek_i#e_t#a_#a#_oln_ndo_lni_eke_ket_et#_#in	indokolni_ezeket_a
jel_ens_#ez_#je_ns#_zek_eze_t#a_#a#_ele_len_ket_eke_et#_a#j	ezeket_a_jelens
jel_ens_#je_ns#_s#g_#ge_a#j_gek_#a#_eke_ket_len_et#_ele	a_jelens_geket
jel_#je_ns#_s#g_#ge_gek_ele_eke_ket_len_et#_#A#_t#A_ens	jelens_geket_A
or#_#ge_gek_#ko_kor_ket_eke_et#_#A#_A#k_t#A	geket_A_kor
or#_bba_r#b_#ko_kor_ban_an#_#A#_#bb_A#k	A_kor_bban
or#_cio_bba_ond_ici_r#b_#ko_kor_ban_an#_n#k_on#_kon_#bb_ndi_dic_ion	kor_bban_kondicion
cio_bba_n#l_ond_ici_#lt_#ko_ban_n#k_an#_on#_kon_#bb_ndi_dic_lt#_ion	bban_kondicion_lt
cio_t#g_n#l_ond_ici_#ko_#g#_lt#_on#_kon_dic_ndi_#lt_ion	kondicion_lt_g
t#g_tl#_#tl_g#t_lt#_#lt_#g#	lt_g_tl
l#m_gsz_tl#_#tl_egs_g#t_sz#_meg_#me_#g#	g_tl_megsz
l#m_gsz_#n#_z#n_tl#_#tl_egs_sz#_meg_#me	tl_megsz_n
gsz_#se_#n#_z#n_n#s_egs_sz#_se#_meg_#me	megsz_n_se
#se_#sz_e#s_#n#_rke_n#s_erk_kes_sze_esz_szt_zer_zt#_se#	n_se_szerkeszt
#se_#sz_e#s_rke_erk_kes_sze_esz_szt_#s#_zer_t#s_zt#_se#	se_szerkeszt_s
#sz_#Az_Az#_rke_erk_kes_sze_esz_szt_#s#_zer_t#s_zt#_s#A	szerkeszt_s_Az
#RW_#Az_Az#_z#R_#s#_s#A_RW#	s_Az_RW
#RW_Az#_#Az_z#R_ode_#mo_ll#_del_W#m_mod_ell_RW#	Az_RW_modell
l#b_bej_#RW_ode_#mo_ll#_del_mod_W#m_#be_ej#_ell_RW#	RW_modell_bej
l#b_bej_ode_#so_sol_#mo_ll#_del_mod_olj_j#s_#be_ja#_ej#_ell_lja	modell_bej_solja
bej_#so_sol_ogy_gy#_a#h_#ho_olj_hog_j#s_#be_ja#_ej#_lja	bej_solja_hogy
sol_#so_ogy_gy#_#ho_y#a_az#_olj_hog_#az_ja#_a#h_lja	solja_hogy_az
sm#_z#i_ogy_gy#_az#_ism_hog_#az_y#a_#ho_#is	hogy_az_ism
sm#_m#t_z#i_tel_#te_az#_ism_lt#_#is_#az_elt	az_ism_telt
sm#_m#t_tel_emu_uta_mut_#te_ism_lt#_tat_#is_at#_t#b_#be_elt_bem	ism_telt_bemutat
sa#_tel_uta_emu_#sa_mut_#te_t#s_lt#_tat_at#_t#b_#be_elt_bem	telt_bemutat_sa
sa#_uta_emu_#sa_mut_a#a_#a#_t#s_tat_at#_#be_bem	bemutat_sa_a
cio_a#k_sa#_ond_ici_a#a_#ko_#a#_kon_on#_#sa_dic_ndi_ion	sa_a_kondicion
cio_a#k_n#l_ond_ici_#ko_#a#_lt#_on#_kon_dic_ndi_#lt_ion	a_kondicion_lt
cio_t#g_n#l_ond_ici_#ko_#g#_lt#_on#_kon_dic_ndi_#lt_ion	kondicion_lt_g
t#g_tl#_#tl_g#t_lt#_#lt_#g#	lt_g_tl
nak_tl#_#tl_g#t_ak#_l#n_#g#_#na	g_tl_nak
mag_nak_tl#_#tl_#nm_nma_ak#_l#n_ag#_k#n_#na	tl_nak_nmag
mag_nak_#nm_nma_ban_ak#_g#b_#ba_an#_ag#_k#n_#na	nak_nmag_ban
mag_n#a_#nm_nma_ban_#a#_g#b_#ba_an#_ag#	nmag_ban_a
n#a_#CS_#a#_ban_an#_#ba_CS#_a#C	ban_a_CS
#CS_ega_S#n_at#_#a#_#ne_neg_gat_CS#_a#C	a_CS_negat
#v#_#CS_ega_S#n_at#_neg_#ne_gat_CS#_t#v	CS_negat_v
oci_#v#_ssz_zoc_gat_v#a_ass_cia_ega_iat_neg_#ne_#as_at#_t#v_szo	negat_v_asszociat
oci_#v#_ssz_zoc_v#a_ass_cia_iat_#as_at#_t#v_szo	v_asszociat_v
oci_zoc_ssz_#v#_#er_v#e_ass_cia_iat_er#_#as_at#_t#v_szo	asszociat_v_er
#v#_#er_v#e_el#_er#_#ve_vel_r#v	v_er_vel
#er_l#a_el#_er#_#ve_az#_vel_#az_r#v	er_vel_az
l#a_z#i_el#_nge_ger_#ve_az#_vel_er#_ing_#az_#in	vel_az_inger
r#k_hal_z#i_#ki_nge_ger_er#_az#_ing_kih_al#_#az_#in_iha	az_inger_kihal
r#k_hal_#ki_l#s_ger_nge_er#_#s#_ing_kih_al#_#in_iha	inger_kihal_s
hal_#t#_#ki_l#s_#s#_kih_al#_iha_s#t	kihal_s_t
red_edm_#er_t#e_#t#_dm#_#s#_ere_s#t	s_t_eredm
red_edm_#er_t#e_#t#_dm#_yez_#ny_ezi_m#n_ere_zi#_nye	t_eredm_nyezi
red_edm_#er_dm#_yez_#ny_ega_at#_ezi_#ne_neg_gat_m#n_ere_zi#_i#n_nye	eredm_nyezi_negat
#v#_yez_ega_at#_ezi_#ne_neg_gat_#ny_zi#_t#v_i#n_nye	nyezi_negat_v
oci_#v#_ssz_zoc_gat_v#a_ass_cia_ega_iat_neg_#ne_#as_at#_t#v_szo	negat_v_asszociat
oci_#v#_ssz_zoc_v#a_ass_cia_iat_#as_at#_t#v_szo	v_asszociat_v
oci_zoc_ssz_#v#_ass_cia_iat_v#r_#rt_#as_rt#_at#_t#v_szo	asszociat_v_rt
#v#_#k#_v#r_#rt_rt#_t#k	v_rt_k
#cs_#k#_k#c_#rt_rt#_cs#_t#k	rt_k_cs
#cs_#k#_#kk_k#c_ken_s#k_kke_nn#_cs#_enn	k_cs_kkenn
#cs_#se_#kk_n#s_ken_s#k_kke_nn#_se#_cs#_enn	cs_kkenn_se
#Ez_#se_Ez#_#kk_n#s_e#E_nn#_kke_se#_ken_enn	kkenn_se_Ez
#Ez_#eg_#se_Ez#_egy_e#E_z#e_gy#_se#	se_Ez_egy
#eg_#Ez_ami_Ez#_mis_egy_#ha_z#e_gy#_y#h_ham_is#	Ez_egy_hamis
#eg_ami_s#j_mis_egy_#ha_gy#_#j#_y#h_ham_is#	egy_hamis_j
s#j_ami_lat_mis_#ha_#j#_sla_j#s_at#_ham_is#_#sl	hamis_j_slat
zel_#Ez_t#E_lat_el#_Ezz_#j#_sla_zze_j#s_at#_#sl	j_slat_Ezzel
zel_#Ez_t#E_lat_#sz_el#_ben_l#s_Ezz_sze_sla_emb_zze_at#_mbe_zem_en#_#sl	slat_Ezzel_szemben
#Ez_ben_#k#_#sz_el#_l#s_Ezz_sze_emb_n#k_zze_zel_mbe_zem_en#	Ezzel_szemben_k
ben_#k#_#sz_sze_#s#_k#s_emb_n#k_mbe_zem_en#	szemben_k_s
#k#_rle_ek#_#s#_let_k#s_#rl_s#r_tek_ete	k_s_rletek
azt_rle_ek#_#az_#s#_let_k#a_#rl_zt#_s#r_tek_ete	s_rletek_azt
uta_azt_#mu_atj_rle_ek#_mut_tj#_let_k#a_#rl_zt#_tat_#az_t#m_tek_ete	rletek_azt_mutatj
uta_#k#_#mu_atj_mut_tj#_zt#_tat_j#k_#az_t#m_azt	azt_mutatj_k
uta_#k#_atj_#mu_k#h_ogy_mut_hog_tj#_gy#_tat_j#k_#ho	mutatj_k_hogy
k#h_#k#_ogy_gy#_#a#_hog_y#a_#ho	k_hogy_a
a#k_nd#_ond_ogy_gy#_#ko_#a#_hog_kon_y#a_#ho	hogy_a_kond
a#k_nd#_ond_#ko_#a#_ci#_#ci_kon_d#c	a_kond_ci
nal_nd#_ond_#ko_ci#_alt_lt#_#ci_kon_d#c_i#n_#na	kond_ci_nalt
t#g_nal_ci#_alt_lt#_#ci_#g#_i#n_#na	ci_nalt_g
t#g_nal_tl#_#tl_g#t_lt#_alt_#g#_#na	nalt_g_tl
sm#_tl#_#tl_l#i_g#t_ism_#is_#g#	g_tl_ism
sm#_m#t_tel_tl#_#tl_#te_l#i_ism_lt#_#is_elt	tl_ism_telt
sm#_m#t_tel_emu_uta_mut_#te_ism_lt#_tat_#is_at#_t#b_#be_elt_bem	ism_telt_bemutat
sa#_tel_uta_emu_#sa_mut_#te_t#s_lt#_tat_at#_t#b_#be_elt_bem	telt_bemutat_sa
sa#_uta_emu_#sa_#n#_mut_t#s_tat_at#_a#n_#be_bem	bemutat_sa_n
sa#_eli_#n#_n#v_li#_#ve_vel_#sa_a#n	sa_n_veli
eli_#n#_n#v_li#_#ve_i#g_vel_#g#	n_veli_g
eli_li#_tl#_#tl_i#g_#ve_vel_g#t_#g#	veli_g_tl
tl#_#tl_#ha_g#t_hat_l#h_at#_#g#	g_tl_hat
#ha_tl#_#tl_#s#_t#s_hat_l#h_at#	tl_hat_s
#t#_#ha_#s#_t#s_hat_at#_s#t	hat_s_t
cio_#t#_t#j_apo_ici_ion_rap_on#_#s#_ozi_#jr_zic_poz_s#t_jra	s_t_jrapozicion
cio_#t#_t#j_apo_ici_rap_on#_ozi_#jr_n#l_zic_poz_#l#_ion_jra	t_jrapozicion_l
cio_apo_ici_l#s_rap_on#_ozi_#s#_#jr_n#l_zic_poz_#l#_ion_jra	jrapozicion_l_s
s#a_l#s_#s#_#a#_#l#	l_s_a
a#k_s#a_hal_#ki_#a#_#s#_kih_al#_iha	s_a_kihal
a#k_hal_#ki_l#s_#a#_#s#_kih_al#_iha	a_kihal_s
hal_#ki_l#s_#s#_s#u_kih_#ut_ut#_al#_iha	kihal_s_ut
t#n_#n#_#s#_s#u_#ut_ut#	s_ut_n
t#n_#sz_#n#_rke_n#s_erk_kes_sze_esz_szt_zer_#ut_ut#_zt#	ut_n_szerkeszt
#sz_#n#_rke_n#s_erk_kes_sze_esz_szt_#s#_zer_t#s_zt#	n_szerkeszt_s
#sz_#Az_Az#_rke_erk_kes_sze_esz_szt_#s#_zer_t#s_zt#_s#A	szerkeszt_s_Az
#eg_#Az_Az#_egy_ik#_z#e_yik_#s#_s#A_gyi	s_Az_egyik
elt_#eg_#fe_Az#_#Az_egy_ik#_z#e_yik_fel_lt#_k#f_gyi	Az_egyik_felt
elt_#eg_#fe_tel_egy_ik#_yik_#te_fel_ez#_lt#_lez_k#f_gyi_ele_t#t	egyik_felt_telez
tel_#te_fel_#s#_ez#_lt#_lez_#fe_elt_ele_t#t_z#s	felt_telez_s
tel_s#a_#te_#s#_#a#_ez#_z#s_lez_ele	telez_s_a
s#a_ode_ek#_a#m_#mo_del_#a#_#s#_lne_lln_mod_nek_ell	s_a_modellnek
k#h_ode_ek#_a#m_hog_#mo_ogy_gy#_del_#a#_lne_lln_mod_nek_#ho_ell	a_modellnek_hogy
k#h_ode_ek#_ogy_hog_#mo_gy#_del_#a#_lne_lln_mod_nek_y#a_#ho_ell	modellnek_hogy_a
a#C_#CS_ogy_gy#_#a#_hog_CS#_y#a_#ho	hogy_a_CS
cio_S#k_#CS_ond_ici_#ko_#a#_ndi_on#_kon_dic_CS#_a#C_ion	a_CS_kondicion
cio_S#k_n#l_#CS_ond_ici_#ko_ndi_on#_kon_dic_CS#_#l#_ion	CS_kondicion_l
cio_n#l_ond_ici_l#s_#ko_#s#_on#_kon_dic_ndi_#l#_ion	kondicion_l_s
nak_l#s_#s#_s#n_ak#_#l#_#na	l_s_nak
nak_#t#_k#t_#s#_s#n_ak#_#na	s_nak_t
nak_#t#_k#t_#rt_t#r_ak#_rt#_#na	nak_t_rt
t#n_#t#_net_#rt_t#r_#ne_rt#_te#_ete	t_rt_nete
t#n_cs#_net_inc_#rt_#ne_#ni_rt#_te#_ncs_e#n_nin_ete	rt_nete_nincs
cs#_net_#ha_s#h_inc_#ne_#ni_te#_hat_ncs_at#_e#n_nin_ete	nete_nincs_hat
#ss_#ha_s#h_inc_ssa_#ni_t#s_al#_hat_ncs_at#_cs#_nin_sal	nincs_hat_ssal
l#a_#ss_#ha_ssa_#a#_t#s_al#_hat_at#_sal	hat_ssal_a
jel_l#a_leg_#je_enl_#ss_ssa_nle_gi#_#a#_ele_len_al#_egi_a#j_sal	ssal_a_jelenlegi
jel_leg_#je_enl_i#l_#ll_apo_nle_gi#_a#j_ot#_#a#_pot_lla_len_egi_lap_ele	a_jelenlegi_llapot
jel_leg_#je_enl_i#l_#ll_apo_ra#_nle_gi#_ot#_t#r_pot_lla_#ra_len_egi_lap_ele	jelenlegi_llapot_ra
a#c_#cs_apo_ra#_#ll_csa_ot#_sak_t#r_#ra_lla_ak#_lap_pot	llapot_ra_csak
a#c_#cs_ra#_csa_sak_#a#_#ra_ak#_k#a	ra_csak_a
jel_#cs_leg_#je_enl_csa_nle_gi#_sak_#a#_ele_k#a_ak#_len_egi_a#j	csak_a_jelenlegi
jel_oci_zoc_gi#_egi_ele_#je_enl_cia_iat_nle_at#_leg_ass_#a#_#as_a#j_szo_ssz_i#a_len	a_jelenlegi_asszociat
jel_oci_zoc_gi#_egi_ele_#v#_#je_enl_cia_iat_nle_at#_leg_ass_#as_t#v_szo_ssz_i#a_len	jelenlegi_asszociat_v
oci_zoc_ssz_#v#_ass_cia_iat_v#r_#rt_#as_rt#_at#_t#v_szo	asszociat_v_rt
#v#_#ke_ke#_v#r_#rt_rt#_t#k	v_rt_ke
tos_#fo_#ke_nto_ke#_os#_e#f_#rt_rt#_ont_fon_t#k	rt_ke_fontos
tos_#fo_#ke_nke_nto_ke#_os#_e#f_enk_lle_Ell_ez#_#El_len_ont_kez_s#E_fon	ke_fontos_Ellenkez
tos_#le_#fo_leg_eg#_nke_nto_os#_enk_lle_Ell_ez#_#El_len_ont_z#l_kez_s#E_fon	fontos_Ellenkez_leg
#le_leg_eg#_nke_#sz_g#s_enk_lle_sz#_ez#_#El_len_z#l_kez_Ell	Ellenkez_leg_sz
#le_leg_eg#_#sz_g#s_os#_#mo_sz#_mos_z#m	leg_sz_mos
#k#_#sz_os#_#mo_sz#_s#k_mos_z#m	sz_mos_k
#k#_os#_#mo_s#k_#s#_k#s_mos	mos_k_s
#k#_rle_ek#_#s#_let_k#s_#rl_s#r_tek_ete	k_s_rletek
azt_rle_ek#_#az_#s#_let_k#a_#rl_zt#_s#r_tek_ete	s_rletek_azt
uta_azt_#mu_atj_rle_ek#_mut_tj#_let_k#a_#rl_zt#_tat_#az_t#m_tek_ete	rletek_azt_mutatj
uta_#k#_#mu_atj_mut_tj#_zt#_tat_j#k_#az_t#m_azt	azt_mutatj_k
uta_#k#_atj_#mu_k#h_ogy_mut_hog_tj#_gy#_tat_j#k_#ho	mutatj_k_hogy
k#h_#k#_ogy_gy#_az#_hog_#az_y#a_#ho	k_hogy_az
z#i_rek_ek#_ogy_nge_ger_gy#_az#_#in_ing_hog_#az_ere_y#a_#ho	hogy_az_ingerek
z#i_rek_yek_ek#_nge_ger_az#_ely_lye_ing_ame_k#a_mel_#am_#az_ere_#in	az_ingerek_amelyek
k#e_rek_el#_yek_ek#_ger_nge_ely_lye_ing_ame_k#a_mel_#am_#el_ere_#in	ingerek_amelyek_el
k#e_#sz_el#_yek_ek#_l#s_ely_sz#_lye_ame_mel_#el_#am	amelyek_el_sz
#sz_el#_#r#_l#s_sz#_z#r_#el	el_sz_r
cio_r#k_#sz_#r#_ond_ici_#ko_sz#_z#r_on#_kon_dic_ndi_ion	sz_r_kondicion
cio_va#_r#k_lva_#r#_ond_ici_n#l_#ko_#lv_on#_kon_dic_ndi_ion	r_kondicion_lva
cio_tak_va#_lva_lta_n#l_ond_ici_olt_#vo_#ko_ak#_#lv_on#_kon_dic_ndi_vol_a#v_ion	kondicion_lva_voltak
tak_jd#_va#_ajd_olt_#vo_maj_#ma_ak#_#lv_lva_vol_a#v_lta_k#m	lva_voltak_majd
tak_ltv_jd#_va#_ajd_iol_tva_#ki_olt_#vo_maj_ak#_d#k_kio_vol_#ma_lta_k#m	voltak_majd_kioltva
ltv_jd#_va#_ajd_iol_a#k_tva_#ki_#k#_olt_d#k_kio_#ma_maj	majd_kioltva_k
ltv_a#k_va#_nny_iol_#k#_tva_#ki_#nn_olt_yeb_ben_bbe_en#_ebb_kio_k#n_nye	kioltva_k_nnyebben
yeb_nny_ben_#k#_n#f_el#_#nn_fel_bbe_en#_ebb_#fe_k#n_nye	k_nnyebben_fel
yeb_nny_ben_n#f_el#_#nn_fel_bbe_#j#_ebb_l#j_#fe_en#_nye	nnyebben_fel_j
el#_j#t_#th_at#_fel_#j#_hat_l#j_#fe_tha	fel_j_that
#ak_j#t_#th_t#a_#j#_ak#_hat_at#_tha	j_that_ak
tak_#ak_olt_#th_#vo_t#a_k#v_ak#_hat_at#_vol_tha_lta	that_ak_voltak
tak_#ak_olt_#vo_az#_k#v_zaz_k#a_ak#_#az_aza_vol_lta	ak_voltak_azaz
tak_#ke_ves_z#k_olt_kev_#vo_eve_az#_zaz_seb_bb#_k#a_ak#_ebb_#az_ese_aza_vol_lta	voltak_azaz_kevesebb
#ke_ves_ond_ese_aza_#ko_#az_bb#_ndi_dic_cio_b#k_zaz_seb_ebb_kon_z#k_ici_kev_eve_az#_on#_ion	azaz_kevesebb_kondicion
cio_#ke_b#k_ves_ond_kev_ici_eve_n#l_bb#_#ko_seb_ebb_on#_kon_ese_ndi_dic_#l#_ion	kevesebb_kondicion_l
cio_sra_n#l_ond_ici_l#s_ra#_#ko_#sr_on#_kon_dic_ndi_#l#_ion	kondicion_l_sra
sra_ra#_l#s_olt_#vo_lt#_#sr_a#v_vol_#l#	l_sra_volt
sra_#sz_ra#_olt_#vo_sz#_t#s_lt#_#sr_vol_a#v	sra_volt_sz
ks#_#sz_olt_#vo_#ks_sz#_t#s_lt#_z#k_vol	volt_sz_ks
ks#_#sz_#ks_sz#_z#k_s#g_#g#	sz_ks_g
ks#_#ks_#A#_g#A_s#g_#g#	ks_g_A
#se_rke_erk_ser_ent_A#s_nt#_#A#_g#A_ken_#g#	g_A_serkent
#se_rke_erk_ent_A#s_#s#_nt#_t#s_#A#_ser_ken	A_serkent_s
#se_rke_erk_ent_s#s_#s#_nt#_t#s_ser_ken	serkent_s_s
#a#_#s#_s#a_s#s	s_s_a
s#a_#a#_#s#_a#g_#g#	s_a_g
tl#_#tl_g#t_a#g_#a#_#g#	a_g_tl
l#s_tl#_#tl_g#t_#s#_#g#	g_tl_s
#ki_l#s_tl#_#tl_s#k_#s#_kiz_iz#	tl_s_kiz
#ki_#r#_s#k_#s#_z#r_kiz_iz#	s_kiz_r
#la_lag_ago_#ki_#r#_oss_gos_z#r_r#l_kiz_ss#_iz#	kiz_r_lagoss
#la_lag_ago_#r#_oss_gos_ga#_r#l_ss#_s#g_#ga	r_lagoss_ga
#la_lag_ago_#sz_oss_rke_erk_gos_ga#_sze_kes_esz_szt_zer_zt#_a#s_ss#_s#g_#ga	lagoss_ga_szerkeszt
#sz_rke_erk_ga#_sze_kes_esz_szt_zer_t#s_zt#_#s#_a#s_#ga	ga_szerkeszt_s
#sz_#Az_Az#_rke_erk_kes_sze_esz_szt_#s#_zer_t#s_zt#_s#A	szerkeszt_s_Az
#RW_#Az_Az#_z#R_#s#_s#A_RW#	s_Az_RW
#RW_Az#_#Az_z#R_ode_#mo_ll#_del_W#m_mod_ell_RW#	Az_RW_modell
#RW_ode_l#f_#mo_ll#_del_fel_lt#_mod_W#m_#fe_elt_ell_RW#	RW_modell_felt
zi#_tel_ode_#mo_#te_ll#_del_fel_ezi_lt#_mod_l#f_lez_#fe_elt_ele_t#t_ell	modell_felt_telezi
zi#_tel_i#h_ogy_#te_fel_ezi_#ho_gy#_lt#_hog_lez_#fe_elt_ele_t#t	felt_telezi_hogy
zi#_y#s_tel_#se_i#h_ogy_erk_#te_rke_gy#_ezi_#ho_ken_ent_nt#_hog_ser_lez_ele	telezi_hogy_serkent
y#s_#se_rke_ogy_erk_ent_gy#_#s#_nt#_t#s_hog_ser_ken_#ho	hogy_serkent_s
#se_rke_erk_ent_s#s_#s#_nt#_t#s_ser_ken	serkent_s_s
#a#_#s#_s#a_s#s	s_s_a
s#a_#a#_#s#_a#g_#g#	s_a_g
tl#_#tl_g#t_a#g_#a#_#g#	a_g_tl
l#s_tl#_#tl_g#t_#s#_#g#	g_tl_s
nke_l#s_tl#_#tl_lle_enk_#s#_#el_len_ez#_s#e_kez_ell	tl_s_ellenkez
don_ajd_nke_#tu_ns#_enk_lle_laj_ons_#s#_#el_len_ez#_z#t_ula_s#e_jdo_kez_tul_ell	s_ellenkez_tulajdons
don_ajd_nke_#tu_ns#_enk_lle_laj_ons_ula_#el_ez#_jdo_z#t_len_#g#_kez_tul_s#g_ell	ellenkez_tulajdons_g
don_ajd_#Az_#tu_ns#_Az#_laj_ons_ula_jdo_g#A_tul_s#g_#g#	tulajdons_g_Az
#Az_Az#_#sz_szt_zt#_#g#_g#A_z#s	g_Az_szt
nz#_t#n_#sz_Az#_#Az_szt_zt#_z#s_#nz	Az_szt_nz
nz#_t#n_#sz_z#n_ek#_szt_#ne_zt#_nek_#nz	szt_nz_nek
nz#_z#n_ek#_#va_vag_gy#_k#v_#ne_nek_#nz_agy	nz_nek_vagy
y#s_#se_ek#_erk_#va_vag_rke_gy#_k#v_ent_#ne_nt#_nek_ser_ken_agy	nek_vagy_serkent
y#s_zit_#se_t#p_rke_erk_#va_vag_ent_gy#_#po_poz_ozi_nt#_it#_ser_ken_agy	vagy_serkent_pozit
zit_#v#_#se_t#p_rke_erk_ent_poz_it#_#po_ozi_nt#_ser_ken_t#v	serkent_pozit_v
oci_zit_#v#_ssz_zoc_v#a_ass_cia_iat_it#_#po_ozi_#as_at#_poz_t#v_szo	pozit_v_asszociat
oci_#v#_ssz_zoc_v#a_ass_cia_iat_#as_at#_t#v_szo	v_asszociat_v
oci_zoc_ssz_#v#_#er_v#e_ass_cia_eje_iat_je#_#as_rej_at#_ere_t#v_szo	asszociat_v_ereje
#v#_#er_e#v_v#e_eje_je#_#va_vag_gy#_rej_ere_agy	v_ereje_vagy
#er_e#v_eje_y#g_je#_#va_vag_gy#_rej_#g#_ere_agy	ereje_vagy_g
y#g_#va_vag_#tl_gy#_g#t_tl#_#g#_agy	vagy_g_tl
tl#_#tl_#ha_g#t_hat_l#h_at#_#g#	g_tl_hat
sa#_#sa_#ha_tl#_#tl_t#s_hat_l#h_at#	tl_hat_sa
sa#_gat_#sa_#ha_ega_#ne_t#s_neg_hat_a#n_at#	hat_sa_negat
#v#_sa#_gat_ega_#ne_neg_#sa_a#n_at#_t#v	sa_negat_v
oci_#v#_ssz_zoc_gat_v#a_ass_cia_ega_iat_neg_#ne_#as_at#_t#v_szo	negat_v_asszociat
oci_#v#_ssz_zoc_v#a_ass_cia_iat_#as_at#_t#v_szo	v_asszociat_v
oci_zoc_ssz_#v#_#er_v#e_ass_cia_eje_iat_je#_#as_rej_at#_ere_t#v_szo	asszociat_v_ereje
#le_#v#_#er_v#e_eje_leh_je#_ehe_rej_e#l_et#_ere_het	v_ereje_lehet
#le_#er_eje_leh_je#_#de_ehe_rej_e#l_et#_ere_het_t#d_de#	ereje_lehet_de
#le_#mi_tt#_ndk_ett_leh_ind_dke_#de_min_ehe_ket_et#_e#m_het_t#d_de#	lehet_de_mindkett
t#e_ett_ind_sze_err_ysz_de#_#eg_egy_min_zer_e#m_ndk_gys_dke_re#_#mi_#de_rre_ket_tt#	de_mindkett_egyszerre
t#e_ett_ind_sze_err_ysz_nem_#eg_egy_min_zer_ndk_gys_dke_re#_em#_e#n_#mi_rre_#ne_ket_tt#	mindkett_egyszerre_nem
zel_#eg_#Ez_gys_el#_egy_Ezz_sze_err_rre_re#_zer_#ne_ysz_em#_m#E_nem_zze_e#n	egyszerre_nem_Ezzel
zel_#Ez_ben_#sz_el#_l#s_Ezz_sze_em#_#ne_emb_m#E_zze_nem_mbe_zem_en#	nem_Ezzel_szemben
n#n_#Ez_ben_#sz_el#_l#s_#n#_Ezz_sze_emb_zze_zel_mbe_zem_en#	Ezzel_szemben_n
n#n_ben_#sz_n#h_#n#_#ha_sze_emb_mbe_zem_en#_ha#	szemben_n_ha
het_n#h_#n#_a#m_#ha_gye_igy_gfi_yel_lhe_et#_elh_meg_#me_egf_fig_ha#	n_ha_megfigyelhet
het_a#m_#ha_ogy_gye_gy#_igy_gfi_yel_lhe_t#h_et#_hog_elh_meg_#me_#ho_egf_fig_ha#	ha_megfigyelhet_hogy
rek_y#i_nge_gye_igy_ing_elh_het_#in_#me_lhe_gfi_yel_ekn_kne_et#_nek_ere_fig_ek#_gy#_t#h_meg_hog_egf_ogy_ger_#ho	megfigyelhet_hogy_ingereknek
k#k_#k#_rek_y#i_ek#_ogy_nge_ger_gy#_ing_ekn_kne_nek_hog_ere_#in_#ho	hogy_ingereknek_k
k#k_#k#_rek_k#t_ek#_ger_nge_#tf_tf#_ing_ekn_kne_nek_ere_#in	ingereknek_k_tf
#le_f#l_#k#_k#t_#tf_tf#_le#	k_tf_le
#le_don_f#l_ajd_#tu_e#t_ns#_#tf_laj_tf#_ons_ula_jdo_le#_tul	tf_le_tulajdons
#le_don_ajd_#tu_e#t_ns#_laj_ga#_ons_ula_jdo_le#_tul_s#g_#ga	le_tulajdons_ga
don_ajd_#tu_ns#_laj_ga#_ons_ula_is#_jdo_#is_tul_s#g_#ga_a#i	tulajdons_ga_is
#le_het_s#l_leh_ga#_ehe_et#_#is_is#_#ga_a#i	ga_is_lehet
#le_het_t#E_Enn_nne_s#l_leh_ek#_ehe_et#_#is_nek_is#_#En	is_lehet_Ennek
#le_k#e_t#E_Enn_nne_#eg_gyi_leh_ek#_egy_yik_ik#_ehe_et#_nek_het_#En	lehet_Ennek_egyik
k#e_Enn_nne_#eg_#p#_ek#_egy_ik#_yik_nek_k#p_gyi_#En	Ennek_egyik_p
#eg_#p#_ld#_#ld_egy_ik#_yik_k#p_p#l_gyi	egyik_p_ld
#p#_ld#_#ja_#ld_d#j_p#l_ja#	p_ld_ja
ld#_#ja_#ld_d#j_a#a_#a#_ja#	ld_ja_a
#ja_#h#_a#a_#a#_ja#_a#h	ja_a_h
h#t_#tr_ra#_#h#_tra_#a#_a#h	a_h_tra
#se_h#t_#tr_ra#_erk_rke_#h#_tra_ent_nt#_a#s_ser_ken	h_tra_serkent
#tr_ond_nt#_a#s_#se_ra#_#ko_dic_ndi_ser_cio_erk_ent_kon_ken_t#k_ici_rke_tra_on#_ion	tra_serkent_kondicion
cio_#se_n#l_ond_rke_erk_ici_ent_ion_#ko_nt#_ndi_on#_kon_dic_ser_ken_#l#_t#k	serkent_kondicion_l
cio_n#l_ond_ici_l#s_#ko_#s#_on#_kon_dic_ndi_#l#_ion	kondicion_l_s
ben_s#a_l#s_ybe_ely_#s#_ame_mel_#am_lyb_#l#_en#	l_s_amelyben
ben_s#a_n#a_ybe_ely_#s#_ame_mel_#a#_#am_lyb_en#	s_amelyben_a
ben_n#a_#CS_ybe_ely_#a#_ame_mel_#am_lyb_CS#_a#C_en#	amelyben_a_CS
ssz_vis_el#_#vi_#CS_sza_zaf_S#v_fel_#a#_afe_iss_CS#_a#C	a_CS_visszafel
ssz_#p#_vis_el#_#vi_#CS_sza_zaf_S#v_fel_afe_iss_CS#_l#p	CS_visszafel_p
ssz_#p#_p#r_vis_el#_#vi_ros_sza_os#_zaf_fel_#ro_afe_iss_l#p	visszafel_p_ros
#p#_p#r_ros_va#_tva_os#_#tv_#ro_s#t	p_ros_tva
va#_ros_tva_os#_#va_an#_#tv_van_#ro_a#v_s#t	ros_tva_van
va#_tva_n#a_#az_#va_az#_an#_#tv_van_a#v	tva_van_az
US#_n#a_#US_#va_az#_an#_#az_van_z#U	van_az_US
US#_el#_#US_az#_#el_#az_S#e_z#U	az_US_el
US#_el#_#US_#el_l#U_S#e	US_el_US
US#_el#_#CS_#US_#el_l#U_S#C_CS#	el_US_CS
US#_#CS_#US_S#a_#a#_S#C_CS#	US_CS_a
#CS_S#a_#a#_CS#_a#C	CS_a_CS
US#_#CS_#US_#a#_CS#_a#C_S#U	a_CS_US
#he_US#_yet_hel_ett_#CS_#US_ely_lye_CS#_tt#_S#U_S#h	CS_US_helyett
#he_#Ez_US#_yet_hel_ett_t#E_Ez#_#US_ely_lye_tt#_S#h	US_helyett_Ez
#he_#Ez_t#E_yet_hel_ett_Ez#_tal_ely_lye_z#l_al#_#lt_tt#_lta	helyett_Ez_ltal
l#b_#Ez_Ez#_tal_ban_#ba_z#l_al#_#lt_an#_lta	Ez_ltal_ban
l#b_#CS_tal_ban_#ba_an#_al#_#lt_CS#_lta_n#C	ltal_ban_CS
S#t_#t#_#CS_ban_an#_#ba_CS#_n#C	ban_CS_t
cio_#t#_S#t_#CS_ond_ici_ion_#ko_ndi_on#_kon_dic_CS#_t#k	CS_t_kondicion
cio_#t#_n#l_ond_ici_ion_#ko_lt#_on#_kon_dic_ndi_#lt_t#k	t_kondicion_lt
cio_#se_n#l_ond_ici_erk_ser_rke_ken_#ko_ent_t#s_nt#_lt#_on#_kon_dic_ndi_#lt_ion	kondicion_lt_serkent
#v#_#se_rke_erk_ent_t#s_nt#_lt#_#lt_ser_ken_t#v	lt_serkent_v
zi#_#v#_#se_tes_rke_erk_v#t_ent_#te_esz_szi_nt#_ser_ken_t#v	serkent_v_teszi
#v#_i#D_tes_De#_v#t_#te_esz_szi_#De_zi#	v_teszi_De
#rd_rde_i#D_tes_es#_De#_#te_kes_esz_dek_szi_#De_e#r_eke_zi#	teszi_De_rdekes
rde_es#_#m#_De#_s#m_kes_dek_#De_e#r_eke_#rd	De_rdekes_m
rde_don_es#_#m#_s#m_kes_dek_#do_eke_on#_#rd_m#d	rdekes_m_don
don_#m#_n#a_az#_#do_on#_#az_m#d	m_don_az
don_#sz_n#a_az#_szt_#do_zt#_on#_#az_z#s	don_az_szt
nz#_t#n_#sz_szt_az#_zt#_#az_z#s_#nz	az_szt_nz
nz#_t#n_#sz_z#n_ek#_szt_#ne_zt#_nek_#nz	szt_nz_nek
nz#_k#g_z#n_ek#_#ne_nek_#nz_#g#	nz_nek_g
k#g_ek#_tl#_#tl_g#t_#ne_nek_#g#	nek_g_tl
fun_#fu_nkc_tl#_#tl_unk_g#t_ci#_l#f_kci_#g#	g_tl_funkci
fun_#fu_nkc_tl#_#tl_unk_i#i_ci#_l#f_kci_#i#	tl_funkci_i
fun_#fu_nkc_unk_i#i_ci#_#is_kci_is#_#i#	funkci_i_is
ann_nak_#va_s#v_i#i_nna_ak#_#is_van_is#_#i#	i_is_vannak
mi#_ann_nak_ami_#va_s#v_nna_k#a_ak#_#am_#is_van_is#	is_vannak_ami
mi#_i#b_ann_nak_ami_#bi_izo_#va_zon_ny#_k#a_ak#_#am_ony_van_nna_biz	vannak_ami_bizony
mi#_ami_izo_#bi_#th_zon_ny#_ony_#am_hat_at#_i#b_tha_y#t_biz	ami_bizony_that
izo_#bi_#th_zon_ny#_t#a_#a#_ony_hat_at#_tha_y#t_biz	bizony_that_a
ard_ret_#re_#th_tar_rd#_t#a_#a#_a#r_hat_at#_tha_eta	that_a_retard
ard_ret_tar_rd#_d#c_#a#_a#r_ci#_#ci_#re_eta	a_retard_ci
ard_ret_tes_ztj_tar_rd#_d#c_#te_esz_ci#_i#t_szt_tj#_#ci_#re_eta	retard_ci_tesztj
tes_j#v_el#_ztj_#te_tj#_esz_szt_#ve_ci#_vel_#ci_i#t	ci_tesztj_vel
#Ez_tes_j#v_el#_Ez#_l#E_ztj_#te_tj#_szt_esz_#ve_vel	tesztj_vel_Ez
#Ez_Ez#_el#_l#E_#ve_vel_#a#_z#a	vel_Ez_a
#Ez_tes_Ez#_a#t_#te_esz_szt_#a#_zt#_z#a	Ez_a_teszt
tes_uta_#mu_atj_a#t_#te_mut_esz_szt_#a#_tja_zt#_tat_t#m_ja#	a_teszt_mutatja
tes_uta_#mu_atj_mut_#te_tja_szt_esz_a#a_az#_zt#_tat_#az_t#m_ja#	teszt_mutatja_az
uta_#sz_atj_#mu_mut_tja_a#a_az#_szt_zt#_tat_#az_z#s_ja#	mutatja_az_szt
nz#_t#n_#sz_szt_az#_zt#_#az_z#s_#nz	az_szt_nz
nz#_t#n_z#g_#sz_szt_zt#_#nz_#g#	szt_nz_g
z#g_nz#_tl#_#tl_g#t_#nz_#g#	nz_g_tl
tl#_#tl_#ha_g#t_hat_l#h_at#_#g#	g_tl_hat
#ha_tl#_#tl_#s#_t#s_hat_l#h_at#	tl_hat_s
#t#_#ha_#s#_t#s_hat_at#_s#t	hat_s_t
#mi_#t#_el#_miv_vel_#s#_ive_t#m_s#t	s_t_mivel
#mi_l#a_#t#_el#_miv_vel_#a#_ive_t#m	t_mivel_a
#mi_l#a_#se_el#_rke_erk_ent_miv_vel_#a#_nt#_ive_a#s_ser_ken	mivel_a_serkent
cio_#se_ond_rke_erk_ici_ent_ion_#ko_#a#_nt#_kon_ndi_on#_a#s_dic_ser_ken_t#k	a_serkent_kondicion
cio_#se_n#l_ond_rke_erk_ici_ent_ion_#ko_nt#_ndi_on#_kon_dic_ser_ken_#l#_t#k	serkent_kondicion_l
cio_n#l_ond_ici_l#s_#ko_#s#_on#_kon_dic_ndi_#l#_ion	kondicion_l_s
s#a_l#s_az#_#s#_#az_#l#	l_s_az
s#a_el#_z#e_az#_#s#_#el_#az	s_az_el
el#_z#e_az#_l#z_#el_#az_#z#	az_el_z
#le_leg_eg#_el#_l#z_#el_z#l_#z#	el_z_leg
#le_g#k_cio_eg#_leg_ond_ici_#ko_ndi_z#l_on#_kon_dic_#z#_ion	z_leg_kondicion
#le_g#k_cio_leg_eg#_n#l_ond_ici_#ko_lt#_on#_kon_dic_ndi_#lt_ion	leg_kondicion_lt
cio_t#g_n#l_ond_ici_#ko_#g#_lt#_on#_kon_dic_ndi_#lt_ion	kondicion_lt_g
t#g_tl#_#tl_g#t_lt#_#lt_#g#	lt_g_tl
val_tl#_l#v_#tl_#va_g#t_al#_#g#	g_tl_val
val_#va_l#v_tl#_#tl_em#_#ne_al#_nem_l#n	tl_val_nem
val_m#t_#t#_#va_em#_#ne_al#_nem_l#n	val_nem_t
m#t_#t#_#k#_em#_#ne_nem_t#k	nem_t_k
#le_#k#_k#l_#t#_tes_es#_let_t#k_ete	t_k_letes
#le_#k#_k#l_tes_es#_let_s#A_#A#_ete	k_letes_A
#le_ssz_es#_tes_vis_#vi_el#_sza_zaf_fel_let_afe_iss_s#A_#A#_A#v_ete	letes_A_visszafel
ond_sza_A#v_l#k_vis_el#_#vi_fel_#ko_afe_#A#_dic_ndi_cio_iss_kon_ssz_ici_zaf_on#_ion	A_visszafel_kondicion
ond_sza_lt#_l#k_vis_el#_#vi_fel_#ko_afe_n#l_dic_ndi_cio_iss_kon_#lt_ssz_ici_zaf_on#_ion	visszafel_kondicion_lt
cio_n#l_ond_ici_t#i_nge_ger_er#_#ko_#in_ing_lt#_on#_kon_dic_ndi_#lt_ion	kondicion_lt_inger
tes_r#t_t#i_tje_nge_ger_er#_#te_esz_szt_ing_ztj_je#_lt#_#lt_#in	lt_inger_tesztje
nge_esz_ing_#si_#in_res_r#t_er#_#te_ztj_je#_ere_es#_e#s_tje_ike_sik_ker_tes_ger_szt	inger_tesztje_sikeres
res_ker_tes_es#_e#s_tje_ztj_#te_je#_szt_esz_ike_#si_s#s_#s#_sik_ere	tesztje_sikeres_s
res_ker_es#_ike_s#s_gy#_#s#_#si_sik_ere_s#g_#gy	sikeres_s_gy
#t#_gy#_#s#_y#t_s#g_#gy	s_gy_t
t#n_#t#_ik#_gy#_#ni_y#t_nik_#gy	gy_t_nik
t#n_k#h_#t#_ogy_ik#_gy#_#ni_hog_nik_#ho	t_nik_hogy
y#m_#mi_k#h_nd#_ind_ogy_ik#_min_gy#_#ni_hog_nik_#ho	nik_hogy_mind
y#m_#mi_d#a_nd#_ind_ogy_min_gy#_#a#_hog_#ho	hogy_mind_a
#mi_#se_d#a_nd#_ind_erk_rke_ent_min_#a#_nt#_a#s_ser_ken	mind_a_serkent
#se_rke_erk_ent_#a#_#s#_nt#_t#s_a#s_ser_ken	a_serkent_s
#se_rke_erk_ent_#s#_nt#_t#s_ser_ken_s#g_#g#	serkent_s_g
tl#_#tl_g#t_#s#_s#g_#g#	s_g_tl
fun_#fu_nkc_tl#_#tl_unk_g#t_ci#_l#f_kci_#g#	g_tl_funkci
fun_#k#_#fu_nkc_tl#_#tl_unk_ci#_i#k_l#f_kci	tl_funkci_k
egv_fun_ann_#k#_#fu_nak_nkc_gva_unk_ci#_nna_i#k_ak#_van_kci_meg_#me_k#m	funkci_k_megvannak
egv_ann_nak_#k#_gva_#j#_nna_ak#_van_meg_#me_k#j_k#m	k_megvannak_j
j#i_egv_ann_nak_gva_nge_ger_er#_#in_#j#_ing_nna_ak#_van_meg_#me_k#j	megvannak_j_inger
j#i_#p#_r#p_nge_ger_er#_#j#_ing_#in	j_inger_p
#p#_r#p_p#r_ros_os#_ger_nge_er#_ing_#in_#ro	inger_p_ros
#p#_p#r_ros_#t#_os#_#ro_s#t	p_ros_t
sa#_ros_#t#_os#_t#s_#sa_#ro_s#t	ros_t_sa
sa#_#t#_a#a_#a#_t#s_#sa	t_sa_a
cio_a#k_sa#_ond_ici_a#a_#ko_#a#_kon_on#_#sa_dic_ndi_ion	sa_a_kondicion
cio_a#k_n#l_ond_ici_#ko_#a#_lt#_on#_kon_dic_ndi_#lt_ion	a_kondicion_lt
cio_t#g_n#l_ond_ici_#ko_#g#_lt#_on#_kon_dic_ndi_#lt_ion	kondicion_lt_g
t#g_tl#_#tl_g#t_lt#_#lt_#g#	lt_g_tl
val_tl#_l#v_#tl_#va_g#t_al#_#g#	g_tl_val
val_#sz_l#s_rke_erk_#va_l#v_tl#_#tl_sze_kes_esz_zer_szt_zt#_al#	tl_val_szerkeszt
val_#sz_l#s_rke_erk_#va_kes_sze_esz_szt_#s#_zer_t#s_zt#_al#	val_szerkeszt_s
#sz_rke_erk_kes_sze_esz_szt_#s#_zer_t#s_zt#_s#A_#A#	szerkeszt_s_A
cio_ond_ici_#ko_on#_#s#_#A#_s#A_kon_A#k_ndi_dic_ion	s_A_kondicion
cio_n#l_ond_ici_#lt_#ko_lt#_#A#_on#_kon_A#k_ndi_dic_ion	A_kondicion_lt
cio_t#g_n#l_ond_ici_#ko_#g#_lt#_on#_kon_dic_ndi_#lt_ion	kondicion_lt_g
t#g_tl#_#tl_g#t_lt#_#lt_#g#	lt_g_tl
nak_tl#_#tl_g#t_ak#_l#n_#g#_#na	g_tl_nak
nak_#fe_tl#_#tl_fel_ak#_lt#_l#n_k#f_elt_#na	tl_nak_felt
het_nak_#fe_tel_#te_ezh_fel_ak#_lt#_zhe_et#_lez_k#f_elt_ele_t#t_#na	nak_felt_telezhet
het_tel_t#e_#en_#te_ezh_fel_lt#_zhe_et#_lez_#fe_elt_ele_t#t_en#	felt_telezhet_en
het_n#n_tel_t#e_#en_ega_#te_ezh_#ne_neg_et#_gat_zhe_at#_lez_ele_en#	telezhet_en_negat
n#n_#v#_#en_ega_neg_#ne_gat_at#_t#v_en#	en_negat_v
oci_#v#_ssz_zoc_gat_v#a_ass_cia_ega_iat_neg_#ne_#as_at#_t#v_szo	negat_v_asszociat
oci_#v#_ssz_zoc_v#a_ass_cia_iat_#as_at#_t#v_szo	v_asszociat_v
oci_zoc_ssz_#v#_ass_cia_iat_v#r_#rt_#as_rt#_at#_t#v_szo	asszociat_v_rt
#v#_#ke_ke#_v#r_#rt_rt#_t#k	v_rt_ke
#ke_e#v_ke#_#va_#rt_rt#_an#_van_t#k	rt_ke_van
#ke_e#v_ke#_#va_n#H_an#_#Ha_van_Ha#	ke_van_Ha
#va_#j#_n#H_an#_#Ha_van_a#j_Ha#	van_Ha_j
j#i_nge_ger_ert_#j#_ing_rt#_#Ha_#in_a#j_Ha#	Ha_j_ingert
j#i_oci_zoc_ssz_ass_cia_nge_ger_ert_iat_t#a_#j#_ing_#as_rt#_at#_#in_szo	j_ingert_asszociat
oci_zoc_ssz_#v#_ass_cia_ger_ert_nge_iat_t#a_ing_#as_rt#_at#_#in_t#v_szo	ingert_asszociat_v
oci_zoc_ssz_#v#_#er_v#e_ass_cia_eje_iat_je#_#as_rej_at#_ere_t#v_szo	asszociat_v_ereje
#v#_#er_nul_ull_v#e_eje_je#_#nu_la#_rej_lla_ere_e#n	v_ereje_nulla
dun_adu_#er_nul_ull_eje_nk#_je#_unk_a#a_#nu_la#_rej_lla_ere_e#n_#ad	ereje_nulla_adunk
dun_adu_nul_ull_nk#_unk_a#a_la#_#a#_k#a_lla_#nu_#ad	nulla_adunk_a
adu_nk#_unk_#a#_a#g_k#a_#g#_#ad_dun	adunk_a_g
tl#_#tl_g#t_a#g_#a#_#g#	a_g_tl
hoz_tl#_#tl_g#t_l#h_oz#_#ho_#g#	g_tl_hoz
hoz_tl#_#tl_#a#_z#a_l#h_oz#_#ho	tl_hoz_a
ode_hoz_a#m_#mo_ll#_del_#a#_z#a_mod_oz#_#ho_ell	hoz_a_modell
l#a_ode_a#m_#mo_ll#_del_#a#_zt#_mod_#az_ell_azt	a_modell_azt
l#a_ode_t#j_#mo_ll#_del_#j#_zt#_mod_#az_ell_azt	modell_azt_j
j#s_#so_t#j_sol_#j#_zt#_olj_#az_ja#_lja_azt	azt_j_solja
sol_#so_ogy_gy#_#ho_#j#_olj_hog_j#s_ja#_a#h_lja	j_solja_hogy
sol_#so_ogy_gy#_#ho_y#a_az#_olj_hog_#az_ja#_a#h_lja	solja_hogy_az
ogy_gy#_az#_#j#_z#j_hog_#az_y#a_#ho	hogy_az_j
jel_j#j_#je_lz#_elz_az#_#j#_z#j_#az	az_j_jelz
jel_#je_z#n_lz#_ek#_elz_#j#_#ne_nek_j#j	j_jelz_nek
jel_#ke_k#k_#je_z#n_lz#_ek#_elz_ll#_#ne_kel_nek_ell	jelz_nek_kell
cio_#ke_k#k_l#k_ond_ek#_ici_ion_ll#_#ko_#ne_kel_nek_on#_kon_dic_ndi_ell	nek_kell_kondicion
cio_#ke_l#k_n#l_ond_ici_ion_ll#_#ko_kel_lt#_on#_kon_dic_ndi_#lt_ell	kell_kondicion_lt
cio_#se_n#l_ond_ici_erk_ser_rke_ken_#ko_ent_t#s_nt#_lt#_on#_kon_dic_ndi_#lt_ion	kondicion_lt_serkent
#v#_#se_rke_erk_ent_t#s_nt#_lt#_#lt_ser_ken_t#v	lt_serkent_v
#v#_#se_rke_erk_ent_nt#_v#v_ser_ken_t#v	serkent_v_v
#v#_v#l_nia_lni_ia#_v#v_#ln	v_v_lnia
a#N_#v#_v#l_em#_nia_lni_ia#_Nem_#Ne_#ln	v_lnia_Nem
a#N_#ez_m#e_em#_nia_ez#_lni_ia#_Nem_#Ne_#ln	lnia_Nem_ez
#ez_m#e_em#_#a#_ez#_z#a_Nem_#Ne	Nem_ez_a
#he_#ez_hel_zet_lyz_ely_#a#_ez#_z#a_et#_yze_a#h	ez_a_helyzet
#he_#k#_hel_zet_lyz_ely_#a#_et#_yze_a#h_t#k	a_helyzet_k
#he_#k#_hel_zet_lyz_ely_#s#_k#s_et#_yze_t#k	helyzet_k_s
ti#_#k#_rle_eti_#s#_let_k#s_#rl_s#r	k_s_rleti
#he_ti#_ben_hel_zet_tek_rle_eti_i#h_lyz_kbe_ely_ekb_#s#_let_#rl_s#r_yze_en#_ete	s_rleti_helyzetekben
#he_ti#_ben_hel_zet_tek_eti_rle_i#h_lyz_kbe_ely_ekb_let_#rl_#A#_n#A_yze_en#_ete	rleti_helyzetekben_A
#mo_ekb_del_yze_lyz_kbe_ely_#A#_n#A_mod_ell_ben_ode_A#m_ete_#he_hel_zet_ll#_tek_en#	helyzetekben_A_modell
ode_el#_l#e_#mo_ll#_del_#el_mod_#A#_A#m_ell	A_modell_el
l#r_jel_ode_el#_eje_lz#_l#e_#mo_elz_ll#_del_#el_rej_mod_#re_ell	modell_el_rejelz
l#r_jel_#se_el#_eje_lz#_elz_#el_rej_se#_z#s_#re	el_rejelz_se
jel_#se_eje_lz#_elz_az#_e#a_rej_se#_#az_z#s_#re	rejelz_se_az
#se_ala_ap#_az#_e#a_#al_se#_z#a_#az_lap	se_az_alap
#fo_ala_fog_lom_oga_alo_p#f_az#_gal_mb#_omb_#al_z#a_lap_#az_ap#	az_alap_fogalomb
#fo_ala_fog_lom_oga_alo_p#f_gal_mb#_omb_#al_b#l_lap_ap#_#l#	alap_fogalomb_l
amb_#fo_#la_fog_lom_oga_alo_da#_gal_l#l_mbd_mb#_omb_b#l_bda_lam_#l#	fogalomb_l_lambda
amb_a#V_#la_#V#_#l#_l#l_mbd_da#_bda_lam	l_lambda_V
amb_a#V_#la_#er_red_#V#_V#e_da#_mbd_ed#_bda_ere_lam	lambda_V_ered
red_#er_#Mi_Miv_el#_#V#_V#e_vel_ed#_ive_ere_d#M	V_ered_Mivel
red_#er_#Mi_Miv_l#a_el#_az#_vel_ed#_ive_#az_ere_d#M	ered_Mivel_az
Miv_#Mi_l#a_ssz_el#_zes_#ss_es#_az#_vel_sze_ive_#az_z#s	Mivel_az_sszes
ssz_es#_zes_tet_ett_#ss_#te_az#_sze_#az_z#s_tt#_s#t	az_sszes_tett
oci_zoc_ssz_es#_zes_tet_ett_#ss_ass_cia_iat_#te_sze_t#a_#as_at#_tt#_szo_s#t	sszes_tett_asszociat
oci_zoc_ssz_#v#_ett_tet_ass_cia_iat_#te_t#v_t#a_#as_at#_tt#_szo	tett_asszociat_v
oci_zoc_ssz_#v#_#er_v#e_ass_cia_eje_iat_je#_#as_rej_at#_ere_t#v_szo	asszociat_v_ereje
#v#_#er_v#e_eje_je#_az#_e#a_rej_#az_ere	v_ereje_az
#er_ssz_es#_zes_eje_#ss_je#_az#_e#a_sze_rej_#az_ere_z#s	ereje_az_sszes
ern_ssz_es#_zes_s#i_#ss_ek#_nge_ger_az#_sze_rne_ing_nek_#az_z#s_#in	az_sszes_ingernek
ern_ssz_es#_zes_s#i_#ss_ek#_#V#_nge_ger_sze_rne_k#V_ing_nek_#in	sszes_ingernek_V
mi#_ern_V#a_ami_#V#_ek#_ger_nge_rne_k#V_ing_nek_#am_#in	ingernek_V_ami
mi#_jel_V#a_ami_i#j_#je_#V#_#am_len_ele_en#	V_ami_jelen
mi#_jel_ami_#je_i#j_n#v_#va_an#_#am_len_van_ele_en#	ami_jelen_van
jel_n#n_ati_#je_n#v_#va_ega_tiv_#ne_neg_iv#_an#_len_gat_van_ele_en#	jelen_van_negativ
ati_n#n_nul_ull_v#n_#va_ega_tiv_#nu_la#_#ne_neg_iv#_an#_lla_gat_van	van_negativ_nulla
ati_nul_ull_v#n_ega_tiv_la#_a#g_neg_#ne_iv#_lla_gat_#nu_#g#	negativ_nulla_g
nul_ull_tl#_#tl_la#_a#g_g#t_lla_#nu_#g#	nulla_g_tl
tl#_#tl_#ha_g#t_hat_l#h_at#_#g#	g_tl_hat
sa#_#sa_#ha_tl#_#tl_t#s_hat_l#h_at#	tl_hat_sa
sa#_#sa_a#s_#ha_#s#_t#s_hat_at#	hat_sa_s
sa#_s#a_a#s_#s#_#a#_#sa	sa_s_a
amb_#la_s#a_da#_mbd_#a#_#s#_bda_a#l_lam	s_a_lambda
amb_#la_nul_ull_da#_mbd_#a#_la#_lla_bda_a#n_#nu_a#l_lam	a_lambda_nulla
amb_#la_nul_ull_da#_inc_mbd_la#_#ni_lla_bda_a#n_#nu_cs#_lam_nin_ncs	lambda_nulla_nincs
jel_s#j_nul_ull_#je_inc_la#_#ni_en#_lla_len_a#n_#nu_cs#_ele_nin_ncs	nulla_nincs_jelen
jel_s#j_#je_n#a_inc_az#_#ni_en#_len_#az_ncs_cs#_ele_nin	nincs_jelen_az
jel_US#_#je_n#a_#US_az#_len_#az_ele_z#U_en#	jelen_az_US
US#_#US_S#a_az#_#az_z#U	az_US_az
#eb_US#_#US_S#a_z#e_az#_ebb_#az_bb#	US_az_ebb
#eb_z#e_az#_ebb_b#l_#az_bb#_#l#	az_ebb_l
red_#eb_#er_l#e_ed#_ebb_b#l_bb#_ere_#l#	ebb_l_ered
red_#v#_#er_l#e_ed#_ere_#l#_d#v	l_ered_v
red_lto_#v#_#er_v#l_ed#_toz_#lt_ere_oz#_d#v	ered_v_ltoz
lto_#v#_v#l_#s#_toz_#lt_z#s_oz#	v_ltoz_s
lto_oci_zoc_ssz_s#a_ass_cia_iat_at#_#s#_#as_toz_#lt_z#s_oz#_szo	ltoz_s_asszociat
oci_zoc_ssz_#v#_s#a_ass_cia_iat_#s#_#as_at#_t#v_szo	s_asszociat_v
oci_zoc_ssz_#v#_#er_v#e_ass_cia_eje_iat_je#_#as_rej_at#_ere_t#v_szo	asszociat_v_ereje
#v#_#er_zit_v#e_eje_je#_it#_e#p_#po_ozi_rej_ere_poz	v_ereje_pozit
zit_#er_#v#_eje_je#_it#_e#p_#po_ozi_rej_ere_poz_t#v	ereje_pozit_v
zit_#v#_it#_v#g_gy#_#po_ozi_poz_t#v_#gy	pozit_v_gy
#v#_v#g_gy#_az#_#az_y#a_#gy	v_gy_az
az#_gy#_#j#_z#j_#az_y#a_#gy	gy_az_j
jel_j#j_#je_lz#_elz_az#_#j#_z#j_#az	az_j_jelz
jel_#eg_#je_lz#_egy_z#e_elz_gy#_#j#_j#j	j_jelz_egy
jel_cio_#eg_#je_y#k_ond_ici_lz#_egy_z#e_elz_gy#_#ko_on#_kon_dic_ndi_ion	jelz_egy_kondicion
cio_lis_#eg_#li_y#k_ond_ici_egy_n#l_#ko_gy#_on#_kon_dic_ndi_is#_ion	egy_kondicion_lis
ond_nt#_is#_#se_s#s_#ko_n#l_dic_ser_ndi_cio_lis_erk_ent_kon_ken_#li_ici_rke_on#_ion	kondicion_lis_serkent
lis_#se_#li_#CS_rke_erk_ent_s#s_ken_t#C_nt#_CS#_ser_is#	lis_serkent_CS
ree_nt#_pos_#pr_CS#_eex_#se_t#C_sur_ser_exp_osu_erk_ent_re#_xpo_ken_pre_#CS_rke_ure_S#p	serkent_CS_preexposure
eex_xpo_pre_exp_#CS_osu_#ha_ure_S#p_at#_ree_re#_sur_e#h_pos_hat_#pr_CS#	CS_preexposure_hat
eex_xpo_sa#_pre_exp_osu_#sa_#ha_ure_ree_re#_sur_e#h_t#s_pos_hat_#pr_at#	preexposure_hat_sa
sa#_#sa_#ha_t#s_hat_at#_a#l_#l#	hat_sa_l
ens_sa#_ns#_#te_ten_#sa_l#t_a#l_#l#	sa_l_tens
ns#_s#g_#te_ten_l#t_ens_#l#_#g#	l_tens_g
ns#_s#g_tl#_#te_#tl_g#t_ten_ens_#g#	tens_g_tl
l#s_tl#_#tl_g#t_#s#_#g#	g_tl_s
#sz_l#s_rke_erk_tl#_#tl_s#s_sze_kes_#s#_esz_zer_szt_zt#	tl_s_szerkeszt
#sz_rke_erk_s#s_sze_kes_#s#_esz_zer_szt_zt#_t#s	s_szerkeszt_s
#sz_rke_erk_kes_sze_esz_szt_#s#_zer_t#s_zt#_s#A_#A#	szerkeszt_s_A
A#C_#CS_#s#_#A#_s#A_CS#	s_A_CS
eex_xpo_pre_A#C_exp_#CS_osu_ure_S#p_ree_re#_sur_pos_#A#_#pr_CS#	A_CS_preexposure
eex_xpo_pre_exp_#CS_osu_#ha_ure_S#p_at#_ree_re#_sur_e#h_pos_hat_#pr_CS#	CS_preexposure_hat
eex_xpo_pre_exp_osu_#ha_ure_ree_re#_sur_e#h_t#s_pos_#s#_hat_#pr_at#	preexposure_hat_s
#m#_#ha_s#m_#s#_t#s_hat_at#	hat_s_m
m#s_#s#_s#m_#m#	s_m_s
#m#_m#s_#n#_#s#_s#n	m_s_n
#n#_n#v_#ve_#s#_s#n_ven_en#	s_n_ven
#n#_n#v_#ve_#l#_n#l_ven_en#	n_ven_l
ens_ns#_#te_#ve_#l#_n#l_l#t_ten_ven_en#	ven_l_tens
ns#_s#g_#te_ten_l#t_ens_#l#_#g#	l_tens_g
ns#_s#g_tl#_#te_#tl_g#t_ten_ens_#g#	tens_g_tl
l#s_tl#_#tl_g#t_#s#_#g#	g_tl_s
s#a_l#s_tl#_#tl_#s#_#a#	tl_s_a
s#a_#a#_#s#_#j#_a#j	s_a_j
j#l_#a#_#j#_a#j_#l#	a_j_l
j#l_mer_ert_l#i_ism_#j#_rt#_#is_#l#_sme	j_l_ismert
el#_mer_ert_gye_l#i_ism_igy_gfi_yel_egf_rt#_#is_t#m_meg_#me_#l#_fig_sme	l_ismert_megfigyel
el#_mer_l#s_ert_gye_ism_igy_gfi_yel_#s#_rt#_#is_t#m_meg_#me_egf_fig_sme	ismert_megfigyel_s
el#_l#s_ogy_s#h_gye_gy#_igy_#s#_gfi_yel_hog_meg_#me_#ho_egf_fig	megfigyel_s_hogy
cio_y#k_ond_ici_ogy_s#h_gy#_#ko_#s#_on#_hog_kon_dic_ndi_#ho_ion	s_hogy_kondicion
cio_y#k_ond_ici_ogy_n#l_gy#_#ko_on#_hog_kon_dic_ndi_#ho_#l#_ion	hogy_kondicion_l
cio_n#l_ond_ici_l#s_#ko_#s#_on#_kon_dic_ndi_#l#_ion	kondicion_l_s
exp_#ex_l#s_#s#_s#e_oz#_xpo_poz_#l#	l_s_expoz
exp_#ex_z#c_#s#_ci#_#ci_s#e_oz#_xpo_poz	s_expoz_ci
exp_#ex_z#c_i#u_ci#_#ut_ut#_#ci_oz#_xpo_poz	expoz_ci_ut
t#n_#n#_i#u_ci#_ut#_#ut_#ci	ci_ut_n
t#n_n#a_#n#_az#_#ut_ut#_#az	ut_n_az
z#i_n#a_#n#_nge_ger_er#_az#_ing_#az_#in	n_az_inger
r#k_#k#_z#i_nge_ger_er#_az#_ing_#az_#in	az_inger_k
r#k_#k#_ger_nge_er#_#s#_ing_k#s_#in	inger_k_s
#k#_bb#_#s#_k#s_s#b_#bb	k_s_bb
#mi_b#m_int_min_bb#_#s#_nt#_s#b_#bb	s_bb_mint
#mi_b#m_#CS_int_min_bb#_t#C_nt#_#bb_CS#	bb_mint_CS
#mi_#fe_#CS_int_t#C_min_S#f_fel_nt#_lt#_CS#_elt	mint_CS_felt
#fe_tel_es#_#CS_les_#te_S#f_fel_lt#_CS#_elt_ele_t#t	CS_felt_teles
tel_es#_s#i_les_nge_#te_ger_fel_#in_er#_ing_lt#_#fe_elt_ele_t#t	felt_teles_inger
tel_es#_s#i_les_nge_#te_ger_er#_em#_ing_#ne_r#n_nem_#in_ele	teles_inger_nem
m#t_#t#_ger_nge_er#_em#_ing_#ne_r#n_nem_#in	inger_nem_t
m#t_#t#_#k#_em#_#ne_nem_t#k	nem_t_k
#le_#k#_k#l_#t#_tes_es#_let_t#k_ete	t_k_letes
#le_#k#_k#l_tes_es#_#Az_Az#_let_s#A_ete	k_letes_Az
#le_RW#_es#_tes_#Az_Az#_z#R_#RW_let_s#A_ete	letes_Az_RW
#RW_Az#_#Az_z#R_ode_#mo_ll#_del_W#m_mod_ell_RW#	Az_RW_modell
#RW_ode_#mo_ll#_del_em#_#ne_mod_W#m_nem_l#n_ell_RW#	RW_modell_nem
ode_#mo_ll#_del_em#_#ne_#j#_mod_nem_l#n_ell_m#j	modell_nem_j
ol#_j#s_#so_sol_em#_#ne_#j#_nem_m#j	nem_j_sol
ol#_emm_sem_#se_sol_#so_l#s_mil_#j#_lye_ily_j#s_yen_mmi_en#	j_sol_semmilyen
ol#_emm_sem_#se_sol_#so_n#h_l#s_hat_#ha_mil_lye_ily_mmi_at#_yen_en#	sol_semmilyen_hat
emm_sem_#se_hat_n#h_#st_#ha_mil_lye_t#s_ily_mmi_at#_yen_st#_en#	semmilyen_hat_st
t#j_#st_#ha_#j#_t#s_hat_at#_st#	hat_st_j
j#i_t#j_nge_ger_er#_#j#_ing_#st_#in_st#	st_j_inger
j#i_r#U_US#_#US_nge_ger_er#_#j#_ing_#in	j_inger_US
r#U_US#_#n#_#US_ger_nge_er#_S#n_ing_#in	inger_US_n
US#_#n#_#US_S#n_#lk_lk#_n#l	US_n_lk
k#l_#li_#n#_li#_#lk_lk#_n#l	n_lk_li
uta_#li_k#l_emu_li#_mut_#lk_lk#_tat_at#_#be_i#b_bem	lk_li_bemutat
or#_uta_#li_emu_#sa_li#_mut_sak_kor_ako_t#s_tat_at#_#be_i#b_bem	li_bemutat_sakor
uta_sak_Mag_#sa_gas_aga_kor_tat_at#_bb#_or#_mut_asa_ako_t#s_abb_#be_sab_r#M_#Ma_emu_bem	bemutat_sakor_Magasabb
or#_gas_ren_b#r_nd#_aga_end_sak_kor_ako_r#M_asa_abb_#Ma_Mag_#sa_bb#_sab_#re	sakor_Magasabb_rend
ren_nd#_ond_Mag_gas_aga_#ko_d#k_b#r_dic_bb#_ndi_#re_cio_end_asa_abb_kon_sab_ici_#Ma_on#_ion	Magasabb_rend_kondicion
cio_ren_nd#_n#l_ond_ici_end_#ko_on#_d#k_kon_dic_ndi_#re_#l#_ion	rend_kondicion_l
cio_n#l_ond_ici_l#s_#ko_#s#_on#_kon_dic_ndi_#l#_ion	kondicion_l_s
#sz_l#s_rke_erk_s#s_sze_kes_#s#_esz_zer_szt_zt#_#l#	l_s_szerkeszt
#sz_rke_erk_s#s_sze_kes_#s#_esz_zer_szt_zt#_t#s	s_szerkeszt_s
#sz_rke_erk_kes_sze_esz_szt_#s#_zer_t#s_zt#_s#A_#A#	szerkeszt_s_A
gas_mag_aga_asa_#s#_abb_#A#_s#A_bb#_A#m_sab_#ma	s_A_magasabb
gas_mag_ren_b#r_nd#_aga_end_asa_abb_#A#_bb#_A#m_sab_#re_#ma	A_magasabb_rend
ren_nd#_ond_gas_aga_#ko_d#k_b#r_dic_bb#_ndi_#re_#ma_cio_mag_end_asa_abb_kon_sab_ici_on#_ion	magasabb_rend_kondicion
cio_ren_nd#_n#l_ond_ici_end_#ko_on#_d#k_kon_dic_ndi_#re_#l#_ion	rend_kondicion_l
cio_n#l_ond_ici_l#s_#ko_#s#_on#_kon_dic_ndi_#l#_ion	kondicion_l_s
or#_l#s_#ko_s#k_#s#_kor_#l#	l_s_kor
or#_bba_r#b_#ko_s#k_#s#_kor_ban_an#_#bb	s_kor_bban
or#_cio_bba_ond_ici_r#b_#ko_kor_ban_an#_n#k_on#_kon_#bb_ndi_dic_ion	kor_bban_kondicion
cio_bba_n#l_ond_ici_#lt_#ko_ban_n#k_an#_on#_kon_#bb_ndi_dic_lt#_ion	bban_kondicion_lt
cio_n#l_ond_ici_#CS_t#C_#ko_CS#_lt#_on#_kon_dic_ndi_#lt_ion	kondicion_lt_CS
#p#_#CS_t#C_S#p_lt#_#lt_CS#	lt_CS_p
#p#_p#r_ros_#CS_os#_S#p_CS#_#ro	CS_p_ros
#p#_p#r_ros_va#_tva_os#_#tv_#ro_s#t	p_ros_tva
va#_ros_tva_os#_#va_an#_#tv_van_#ro_a#v_s#t	ros_tva_van
va#_#eg_tva_egy_#va_n#e_gy#_an#_#tv_van_a#v	tva_van_egy
#eg_egy_#va_n#e_gy#_y#j_#j#_an#_van	van_egy_j
jel_#eg_#je_egy_lz#_elz_y#j_gy#_#j#_j#j	egy_j_jelz
jel_#je_el#_z#v_lz#_elz_#ve_vel_#j#_j#j	j_jelz_vel
jel_l#a_#je_el#_z#v_lz#_elz_#ve_vel_zaz_az#_#az_aza	jelz_vel_azaz
l#a_el#_#ve_az#_vel_zaz_z#a_#az_aza	vel_azaz_az
els_ls#_z#e_az#_zaz_#el_z#a_#az_aza	azaz_az_els
els_ls#_#CS_z#e_az#_#el_#az_s#C_CS#	az_els_CS
US#_els_ls#_#CS_#US_#el_s#C_CS#_S#U	els_CS_US
jd#_US#_ajd_#CS_#US_S#m_CS#_#ma_S#U_maj	CS_US_majd
jd#_US#_ajd_#CS_S#m_#US_d#C_CS#_#ma_maj	US_majd_CS
jd#_ajd_#CS_d#C_S#C_CS#_#ma_maj	majd_CS_CS
#CS_tal_S#l_S#C_al#_#lt_CS#_lta	CS_CS_ltal
l#b_#CS_tal_S#l_ban_#ba_an#_al#_#lt_CS#_lta	CS_ltal_ban
l#b_n#a_#az_tal_az#_ban_#ba_an#_al#_#lt_lta	ltal_ban_az
n#a_az#_ban_#j#_an#_#ba_z#j_#az	ban_az_j
#CS_az#_#j#_z#j_#az_CS#_j#C	az_j_CS
has_son_aso_#CS_#ha_#j#_onl_nl#_CS#_j#C_S#h	j_CS_hasonl
l#r_has_son_aso_#CS_rea_#ha_eak_ci#_onl_kci_nl#_CS#_#re_akc_S#h	CS_hasonl_reakci
l#r_has_kat_son_aso_rea_#ha_#ka_eak_ci#_onl_kci_i#k_at#_nl#_#re_akc	hasonl_reakci_kat
#v#_kat_rea_#ka_t#v_eak_ci#_i#k_at#_kci_#re_akc	reakci_kat_v
#v#_kat_#ka_v#l_lt#_at#_#lt_t#v	kat_v_lt
#v#_#ki_v#l_ki#_lt#_#lt_t#k	v_lt_ki
#mi_#ki_int_i#m_min_ki#_nt#_lt#_#lt_t#k	lt_ki_mint
#mi_#ki_int_i#m_min_ki#_t#a_#a#_nt#	ki_mint_a
#mi_#CS_int_min_t#a_#a#_nt#_CS#_a#C	mint_a_CS
#CS_#a#_#A#_CS#_a#C_S#A	a_CS_A
A#m_ode_#CS_#mo_ll#_del_#A#_mod_CS#_S#A_ell	CS_A_modell
ode_#mo_ll#_del_em#_#ne_mod_#A#_nem_l#n_A#m_ell	A_modell_nem
m#t_ode_#tu_#mo_tud_ll#_del_em#_#ne_udj_dja_mod_nem_l#n_ja#_ell	modell_nem_tudja
dok_oko_m#t_#tu_kol_ind_tud_ln#_udj_em#_#ne_dja_#in_ndo_oln_nem_ja#_a#i	nem_tudja_indokoln
dok_oko_#tu_kol_ind_tud_ln#_udj_#in_dja_oln_ndo_ja#_#i#_a#i_n#i	tudja_indokoln_i
dok_#ez_oko_kol_ezt_ind_ln#_i#e_oln_ndo_zt#_#in_#i#_n#i	indokoln_i_ezt
#ez_ezt_i#e_t#a_#a#_zt#_#i#	i_ezt_a
jel_ens_#ez_#je_ns#_ezt_t#a_#a#_ele_zt#_len_a#j	ezt_a_jelens
jel_ens_#je_ns#_s#g_#ge_a#j_#a#_get_et#_len_ele	a_jelens_get
jel_#mi_#je_ns#_el#_s#g_#ge_miv_vel_ele_get_et#_len_ive_t#m_ens	jelens_get_mivel
#mi_l#a_el#_#ge_miv_vel_#a#_get_et#_ive_t#m	get_mivel_a
#mi_l#a_el#_#CS_miv_vel_#a#_ive_CS#_a#C	mivel_a_CS
#CS_#a#_S#C_CS#_a#C	a_CS_CS
S#k_#k#_#CS_S#C_CS#	CS_CS_k
S#k_#k#_#CS_#s#_k#s_CS#	CS_k_s
#k#_rle_#s#_let_k#s_ekn_#rl_s#r_tek_kn#_ete	k_s_rletekn
rle_#s#_let_ekn_#rl_s#r_n#l_tek_kn#_#l#_ete	s_rletekn_l
cs#_rle_inc_let_#ni_ekn_#rl_ncs_n#l_l#n_tek_kn#_#l#_nin_ete	rletekn_l_nincs
s#a_inc_az#_#ni_#az_l#n_cs#_#l#_nin_ncs	l_nincs_az
US#_s#a_#US_inc_az#_#ni_#az_ncs_cs#_z#U_nin	nincs_az_US
jel_US#_#je_#US_az#_S#j_len_#az_ele_z#U_en#	az_US_jelen
jel_n#D_US#_#je_De#_#US_S#j_#De_len_ele_en#	US_jelen_De
jel_n#D_#je_De#_az#_e#a_#De_len_#az_ele_en#	jelen_De_az
De#_tal_az#_e#a_#De_z#l_al#_#az_#lt_lta	De_az_ltal
tal_hog_ogy_az#_gy#_z#l_al#_#az_l#h_#lt_#ho_lta	az_ltal_hogy
tal_hog_ogy_gy#_#a#_al#_#lt_l#h_y#a_#ho_lta	ltal_hogy_a
a#C_#CS_ogy_gy#_#a#_hog_CS#_y#a_#ho	hogy_a_CS
has_son_aso_#CS_#ha_#a#_onl_nl#_CS#_a#C_S#h	a_CS_hasonl
has_l#k_son_aso_#k#_#CS_#ha_onl_nl#_CS#_S#h	CS_hasonl_k
has_l#k_son_aso_#k#_ppe_pen_#ha_onl_k#p_nl#_#pp_en#	hasonl_k_ppen
ppe_#k#_pen_#vi_vis_n#v_ise_edi_dik_ked_ik#_elk_lke_k#p_sel_#pp_en#	k_ppen_viselkedik
#mi_ppe_pen_vis_#vi_edi_n#v_ise_ik#_int_ked_min_elk_nt#_lke_dik_sel_#pp_en#_k#m	ppen_viselkedik_mint
#mi_vis_edi_#vi_ise_int_ik#_ked_min_t#a_#a#_elk_nt#_lke_sel_dik_k#m	viselkedik_mint_a
#mi_US#_a#U_int_#US_min_t#a_#a#_nt#	mint_a_US
ssz_US#_ze#_a#U_#ss_#US_S#s_sze_#a#	a_US_ssze
#le_ssz_US#_ze#_#ss_leh_#US_S#s_sze_ehe_e#l_et#_het	US_ssze_lehet
t#e_zte_ezt_ni#_gye_sze_ehe_het_#eg_ze#_yez_egy_tni_e#l_et#_tet_#ss_#le_ssz_etn_leh	ssze_lehet_egyeztetni
#le_#eg_t#e_zte_tet_etn_yez_leh_egy_ezt_ni#_gye_i#a_ehe_#a#_tni_et#_het	lehet_egyeztetni_a
llt_#eg_zte_tet_etn_ode_ezt_yez_egy_ni#_i#a_gye_a#m_#mo_#a#_del_tni_lt#_mod_ell	egyeztetni_a_modellt
llt_#ez_t#e_ode_el#_a#m_#mo_del_#a#_lt#_mod_zze_zel_ezz_ell	a_modellt_ezzel
llt_#ez_t#e_l#a_ode_el#_#mo_del_#a#_lt#_mod_zze_zel_ezz_ell	modellt_ezzel_a
#ez_l#a_hat_el#_#ha_a#h_#a#_zze_zel_at#_ezz	ezzel_a_hat
#ss_#ha_ssa_#a#_t#s_al#_hat_at#_a#h_sal	a_hat_ssal
l#r_#ss_rz#_#ha_ssa_t#s_al#_hat_at#_#rz_sal	hat_ssal_rz
l#r_erv_vi#_#ss_rz#_#ks_ssa_sze_zer_ksz_al#_z#k_rvi_#rz_sal	ssal_rz_kszervi
erv_vi#_el#_#ks_sze_i#e_#el_zer_ksz_#rz_z#k_rvi_rz#	rz_kszervi_el
cio_erv_vi#_l#k_el#_ond_ici_#ks_sze_i#e_#ko_#el_zer_ksz_on#_kon_dic_ndi_rvi_ion	kszervi_el_kondicion
cio_l#k_el#_n#l_ond_ici_#ko_#el_on#_kon_dic_ndi_#l#_ion	el_kondicion_l
cio_n#l_ond_ici_l#s_#ko_#s#_on#_kon_dic_ndi_#l#_ion	kondicion_l_s
#sz_l#s_rke_erk_s#s_sze_kes_#s#_esz_zer_szt_zt#_#l#	l_s_szerkeszt
#sz_rke_erk_s#s_sze_kes_#s#_esz_zer_szt_zt#_t#s	s_szerkeszt_s
#sz_rke_erk_kes_sze_esz_szt_#s#_zer_t#s_zt#_#rz_s#r_rz#	szerkeszt_s_rz
erv_vi#_#ks_sze_#s#_zer_ksz_#rz_s#r_z#k_rvi_rz#	s_rz_kszervi
erv_vi#_el#_#ks_sze_i#e_#el_zer_ksz_#rz_z#k_rvi_rz#	rz_kszervi_el
cio_erv_vi#_l#k_el#_ond_ici_#ks_sze_i#e_#ko_#el_zer_ksz_on#_kon_dic_ndi_rvi_ion	kszervi_el_kondicion
cio_l#k_el#_n#l_ond_ici_#ko_#el_on#_kon_dic_ndi_#l#_ion	el_kondicion_l
cio_n#l_ond_ici_l#s_#ko_#s#_on#_kon_dic_ndi_#l#_ion	kondicion_l_s
uta_l#s_tal_#s#_s#u_#ut_al#_#l#	l_s_utal
l#a_uta_tal_az#_#s#_s#u_#ut_al#_#az	s_utal_az
l#a_uta_els_ls#_tal_z#e_az#_#el_#ut_al#_#az	utal_az_els
#p#_els_ls#_z#e_s#p_az#_#el_#az	az_els_p
#p#_p#r_ros_els_ls#_os#_s#p_#el_#ro	els_p_ros
#p#_p#r_ros_#t#_os#_#ro_s#t	p_ros_t
ros_#t#_os#_#s#_t#s_#ro_s#t	ros_t_s
#k#_#t#_s#k_#s#_t#s	t_s_k
#k#_#t#_k#t_s#k_#s#	s_k_t
#k#_#t#_t#j_k#t_#j#	k_t_j
jel_#t#_#je_t#j_lz#_elz_#j#_j#j	t_j_jelz
jel_#je_lz#_elz_#j#_z#j_j#j	j_jelz_j
jel_#je_lz#_elz_#j#_re#_z#j_j#r_#re	jelz_j_re
#CS_re#_#j#_e#C_j#r_CS#_#re	j_re_CS
#CS_re#_S#C_e#C_CS#_#re	re_CS_CS
jd#_ajd_#CS_S#m_S#C_CS#_#ma_maj	CS_CS_majd
jd#_#eg_ajd_#CS_S#m_egy_yik_ik#_d#e_CS#_gyi_#ma_maj	CS_majd_egyik
jd#_#eg_ajd_k#k_#k#_egy_ik#_yik_d#e_gyi_#ma_maj	majd_egyik_k
#eg_#p#_k#k_#k#_egy_ik#_yik_k#p_gyi	egyik_k_p
#p#_p#r_#k#_ros_os#_k#p_#ro	k_p_ros
#p#_p#r_ros_#t#_os#_#ro_s#t	p_ros_t
sa#_ros_#t#_os#_t#s_#sa_#ro_s#t	ros_t_sa
sa#_#t#_#az_a#a_az#_t#s_#sa	t_sa_az
sa#_el#_#az_#US_az#_a#a_USe_#sa_Sel_z#U	sa_az_USel
l#C_el#_#CS_#US_USe_az#_#az_CS#_Sel_z#U	az_USel_CS
l#C_US#_el#_#CS_#US_USe_CS#_Sel_S#U	USel_CS_US
#Ez_US#_Ez#_#CS_#US_S#E_CS#_S#U	CS_US_Ez
#Ez_US#_Ez#_#US_S#E_#a#_z#a	US_Ez_a
#Ez_Ez#_#CS_#a#_z#a_CS#_a#C	Ez_a_CS
#CS_S#s_#a#_#s#_CS#_a#C	a_CS_s
#CS_S#s_#s#_s#C_CS#	CS_s_CS
S#t_#t#_#CS_#s#_s#C_CS#	s_CS_t
cio_#t#_S#t_#CS_ond_ici_ion_#ko_ndi_on#_kon_dic_CS#_t#k	CS_t_kondicion
cio_#t#_n#l_ond_ici_ion_#ko_lt#_on#_kon_dic_ndi_#lt_t#k	t_kondicion_lt
cio_#se_n#l_ond_ici_erk_ser_rke_ken_#ko_ent_t#s_nt#_lt#_on#_kon_dic_ndi_#lt_ion	kondicion_lt_serkent
#v#_#se_rke_erk_ent_t#s_nt#_lt#_#lt_ser_ken_t#v	lt_serkent_v
#v#_#se_rke_erk_ent_nt#_v#v_ser_ken_t#v	serkent_v_v
lto_#v#_ozt_atj_zta_v#l_tja_toz_tat_#lt_v#v_ja#	v_v_ltoztatja
lto_#v#_ozt_atj_#Az_zta_Az#_v#l_tja_toz_tat_#lt_ja#_a#A	v_ltoztatja_Az
lto_RW#_#RW_ozt_atj_#Az_zta_Az#_z#R_tja_toz_tat_#lt_ja#_a#A	ltoztatja_Az_RW
#RW_Az#_#Az_z#R_ode_#mo_ll#_del_W#m_mod_ell_RW#	Az_RW_modell
#RW_ode_#mo_ll#_del_em#_#ne_mod_W#m_nem_l#n_ell_RW#	RW_modell_nem
m#t_ode_#tu_#mo_tud_ll#_del_em#_#ne_udj_dja_mod_nem_l#n_ja#_ell	modell_nem_tudja
mag_m#t_gya_#tu_gma_a#m_tud_ar#_udj_em#_#ne_dja_#me_egm_yar_nem_meg_ja#_agy	nem_tudja_megmagyar
mag_gya_#tu_gma_a#m_r#z_zni_tud_ar#_udj_ni#_dja_egm_#me_yar_#zn_meg_ja#_agy	tudja_megmagyar_zni
mag_#ez_gya_ezt_gma_r#z_zni_ni#_ar#_i#e_egm_#zn_yar_zt#_meg_#me_agy	megmagyar_zni_ezt
#ez_mer_ezt_ni#_zni_ert_i#e_#zn_zt#_rt#_t#m_#me	zni_ezt_mert
#ez_mer_ezt_ert_t#a_#a#_zt#_rt#_t#m_#me	ezt_mert_a
mer_#CS_ert_t#a_#a#_rt#_CS#_#me_a#C	mert_a_CS
#CS_#a#_S#C_CS#_a#C	a_CS_CS
#f#_#CS_S#f_S#C_CS#	CS_CS_f
f#z_#f#_#CS_S#f_#zi_zis_CS#_is#	CS_f_zis
f#z_#k#_#f#_#zi_s#k_zis_is#	f_zis_k
#k#_k#z_#zi_s#k_zis_#z#_is#	zis_k_z
#tt_#k#_k#z_z#t_#z#_tt#	k_z_tt
#mi_#tt_ndk_ind_dk#_min_z#t_t#m_#z#_tt#	z_tt_mindk
#mi_#tt_ndk_#t#_k#t_ind_dk#_min_t#m_tt#	tt_mindk_t
#mi_ern_ndk_#t#_k#t_ind_dk#_t#i_nge_min_ger_rne_ek#_ing_nek_#in	mindk_t_ingernek
ern_#t#_t#i_ek#_nge_ger_az#_rne_ing_k#a_nek_#az_#in	t_ingernek_az
oci_ern_zoc_nge_ing_z#a_rne_#in_cia_iat_k#a_nek_#az_at#_ass_ek#_#as_szo_ssz_ger_az#	ingernek_az_asszociat
oci_zoc_ssz_#v#_ass_cia_iat_az#_#as_z#a_#az_at#_t#v_szo	az_asszociat_v
oci_zoc_ssz_#v#_ass_cia_iat_v#r_#rt_#as_rt#_at#_t#v_szo	asszociat_v_rt
#v#_#ke_ke#_v#r_#rt_rt#_t#k	v_rt_ke
#ke_nul_ull_ke#_la#_#rt_rt#_lla_#nu_e#n_t#k	rt_ke_nulla
nul_#ke_ull_ke#_la#_#s#_lla_a#s_#nu_e#n	ke_nulla_s
nul_s#a_ull_la#_#s#_#a#_lla_a#s_#nu	nulla_s_a
amb_#la_s#a_da#_mbd_#a#_#s#_bda_a#l_lam	s_a_lambda
amb_#la_da#_mbd_#a#_#is_bda_is#_a#l_lam_a#i	a_lambda_is
amb_#la_nul_ull_da#_mbd_la#_s#n_lla_#is_bda_#nu_is#_lam_a#i	lambda_is_nulla
nul_ull_cs#_inc_la#_s#n_#ni_lla_#is_a#n_#nu_is#_nin_ncs	is_nulla_nincs
jel_s#j_nul_ull_#je_inc_la#_#ni_en#_lla_len_a#n_#nu_cs#_ele_nin_ncs	nulla_nincs_jelen
jel_s#j_US#_#je_#US_inc_#ni_en#_n#U_len_ncs_cs#_ele_nin	nincs_jelen_US
jel_US#_#je_#US_S#a_ely_n#U_ame_mel_ly#_#am_len_ele_en#	jelen_US_amely
US#_#US_S#a_ely_em#_ame_mel_ly#_#ne_#am_nem_y#n	US_amely_nem
red_edm_#er_dm#_m#e_ely_em#_ame_mel_ly#_#ne_#am_nem_ere_y#n	amely_nem_eredm
red_edm_#er_dm#_yez_#ny_m#e_em#_#ne_ez#_nem_m#n_ere_nye	nem_eredm_nyez
red_edm_#v#_#er_dm#_yez_#ny_z#v_ez#_m#n_ere_nye	eredm_nyez_v
lto_#v#_yez_z#v_v#l_ez#_toz_#lt_#ny_oz#_nye	nyez_v_ltoz
lto_#v#_#st_v#l_toz_#lt_z#s_oz#_st#	v_ltoz_st
lto_#az_#st_az#_t#a_toz_#lt_z#s_oz#_st#	ltoz_st_az
z#i_nge_ger_er#_az#_t#a_ing_#az_#st_#in_st#	st_az_inger
oci_zoc_ssz_z#i_r#a_ass_cia_nge_ger_er#_az#_iat_ing_#as_#az_at#_#in_szo	az_inger_asszociat
oci_zoc_ssz_#v#_r#a_ass_cia_ger_nge_er#_iat_ing_#as_at#_#in_t#v_szo	inger_asszociat_v
oci_zoc_ssz_#v#_#er_v#e_ass_cia_iat_#as_rej_ej#_at#_ere_t#v_szo	asszociat_v_erej
#v#_#er_ben_v#e_j#b_rej_#be_ere_ej#_en#	v_erej_ben
#er_ben_Hiv_j#b_iva_atk_#Hi_vat_n#H_tko_rej_#be_koz_ere_oz#_ej#_en#	erej_ben_Hivatkoz
ben_ok#_Hiv_#so_atk_iva_sok_z#s_vat_n#H_en#_tko_koz_#be_oz#_#Hi	ben_Hivatkoz_sok
ok#_#sz_sze_esz_oz#_#Hi_Hiv_sok_kes_tko_zer_zt#_atk_erk_koz_#so_iva_rke_vat_szt_k#s_z#s	Hivatkoz_sok_szerkeszt
ok#_#sz_sok_#so_rke_erk_kes_sze_esz_szt_#s#_k#s_zer_zt#_t#s	sok_szerkeszt_s
s#a_#sz_rke_erk_kes_sze_esz_szt_#s#_zer_t#s_zt#_#a#	szerkeszt_s_a
s#a_a#b_#a#_#s#_#b#	s_a_b
#Mi_Mil_ill_a#b_ler_er#_lle_#a#_#b#_b#M	a_b_Miller
#Mi_Mil_r#R_ill_#Ra_lph_ler_er#_lle_ph#_alp_Ral_#b#_b#M	b_Miller_Ralph
#Mi_Mil_r#R_ill_h#R_#Ra_lph_ler_er#_lle_ph#_#R#_alp_Ral	Miller_Ralph_R
R#B_h#R_#Ra_lph_net_#Ba_ph#_#R#_alp_Ral_arn_et#_rne_Bar	Ralph_R_Barnet
R#B_t#R_ber_net_#Ro_Rob_ert_#Ba_#R#_obe_arn_et#_rt#_rne_Bar	R_Barnet_Robert
t#R_ber_net_#Ro_Rob_ert_t#C_#Ba_#C#_obe_arn_et#_rt#_rne_Bar	Barnet_Robert_C
#Gr_ber_Rob_ert_#Ro_t#C_C#G_ame_obe_rt#_rah_#C#_me#_aha_ham_Gra	Robert_C_Grahame
#Gr_las_ola_e#N_Nic_as#_C#G_ich_ame_#Ni_me#_rah_#C#_hol_aha_ham_Gra_cho	C_Grahame_Nicholas
#Gr_las_ola_Nic_as#_ich_ame_#Ni_s#J_#J#_me#_hol_rah_e#N_ham_aha_Gra_cho	Grahame_Nicholas_J
orl_las_ola_Nic_as#_esc_sco_ich_J#R_la#_Res_#Ni_#J#_#Re_hol_cor_rla_s#J_cho	Nicholas_J_Rescorla
orl_a#W_agn_esc_Wag_ner_er#_J#R_la#_Res_#J#_#Re_rla_cor_gne_#Wa_sco	J_Rescorla_Wagner
ner_Wag_#mo_del_rla_sco_orl_el#_esc_er#_mod_cor_a#W_ode_agn_la#_r#m_Res_#Re_gne_#Wa	Rescorla_Wagner_model
l#r_r#m_ode_el#_agn_Wag_ner_er#_#mo_del_#rt_rt#_mod_gne_#Wa	Wagner_model_rt
l#r_#ke_ode_el#_#mo_del_#rt_rt#_mod_kel_t#k	model_rt_kel
#ke_#se_el#_l#s_#rt_rt#_kel_se#_t#k	rt_kel_se
#ke_#se_syc_el#_al#_l#s_ogi_log_e#P_ych_olo_gic_cal_ica_kel_se#_hol_#Ps_Psy_cho	kel_se_Psychological
syc_e#P_gic_cal_#Bu_let_l#B_Psy_tin_#se_se#_al#_hol_cho_ull_eti_Bul_olo_in#_log_ych_lle_ica_ogi_#Ps	se_Psychological_Bulletin
Ame_syc_ika_mer_gic_cal_#Bu_let_l#B_Psy_tin_eri_hol_al#_n#A_cho_ull_eti_Bul_olo_kai_in#_rik_ai#_log_ych_lle_ica_ogi_#Am_#Ps	Psychological_Bulletin_Amerikai
Psz_Ame_ika_mer_#Bu_let_tin_eri_szi_hol_n#A_zic_cho_ol#_ull_eti_Bul_i#P_ich_kai_in#_rik_ai#_lle_#Am_#Ps	Bulletin_Amerikai_Pszichol
Psz_Ame_ika_mer_gia_eri_szi_hol_zic_cho_ol#_i#P_ich_#gi_kai_iai_rik_ai#_#Am_l#g_#Ps	Amerikai_Pszichol_giai
ol#_Psz_l#g_ai#_#T#_ich_i#T_szi_hol_gia_zic_#gi_iai_#Ps_cho	Pszichol_giai_T
T#r_sas_ai#_#T#_as#_rsa_#rs_i#T_gia_#gi_iai	giai_T_rsas
T#r_sas_#T#_as#_rsa_#rs_s#g_#g#	T_rsas_g
sas_oi#_as#_doi_rsa_#rs_g#d_#do_s#g_#g#	rsas_g_doi
oi#_doi_i#P_#PM_g#d_PMI_#do_MID_#g#_ID#	g_doi_PMID
D#V_#Va_oi#_doi_#PM_i#P_PMI_#do_Van_an#_MID_ID#	doi_PMID_Van
Ham_D#V_#Va_mme_#PM_n#H_PMI_Van_an#_#Ha_me#_amm_MID_ID#	PMID_Van_Hamme
Ham_mme_#Va_#LJ_n#H_Van_an#_#Ha_me#_LJ#_e#L_amm	Van_Hamme_LJ
Ham_mme_J#s_#LJ_#s#_me#_#Ha_LJ#_e#L_amm	Hamme_LJ_s
s#W_rma_J#s_ass_Was_man_#LJ_#s#_sse_erm_LJ#_an#_ser_#Wa	LJ_s_Wasserman
s#W_rma_ass_Was_man_#E#_#s#_sse_erm_an#_n#E_ser_#Wa	s_Wasserman_E
rma_ass_Was_man_#E#_sse_erm_an#_E#A_#A#_n#E_ser_#Wa	Wasserman_E_A
Cue_A#C_#Cu_#E#_#A#_E#A_ue#	E_A_Cue
Cue_com_A#C_e#c_omp_eti_tio_#Cu_#co_pet_mpe_#A#_on#_tit_ue#_ion_iti	A_Cue_competition
Cue_com_e#c_omp_eti_tio_#Cu_#co_pet_in#_#in_mpe_on#_tit_n#i_ue#_ion_iti	Cue_competition_in
cau_n#c_mpe_ali_#in_usa_tit_n#i_iti_aus_#co_pet_ity_com_ty#_omp_eti_tio_lit_in#_sal_on#_#ca_ion	competition_in_causality
cau_jud_eme_y#j_n#c_#ju_ali_usa_#in_aus_nts_ity_men_ts#_ty#_ent_gem_lit_sal_dge_in#_udg_#ca	in_causality_judgements
cau_jud_eme_y#j_#ju_ali_usa_aus_he#_nts_ity_men_The_ts#_ty#_ent_gem_lit_#Th_sal_dge_udg_s#T_#ca	causality_judgements_The
dge_jud_rol_le#_eme_he#_ent_nts_#ro_udg_#ju_gem_s#T_e#r_ole_#Th_men_The_ts#	judgements_The_role
rol_he#_e#o_#of_e#r_ole_le#_#Th_The_#ro_of#	The_role_of
ati_#no_ole_le#_ese_res_e#o_tat_f#n_of#_onp_sen_npr_tio_#of_ent_rol_nta_pre_non_on#_#ro_ion	role_of_nonpresentation
ati_onp_n#o_res_pre_nta_ese_non_npr_sen_tio_#of_ent_#no_tat_on#_f#n_ion_of#	of_nonpresentation_of
ati_und_nd#_#no_ese_res_#co_mpo_oun_tat_of#_onp_com_sen_npr_omp_tio_ent_#of_f#c_pou_n#o_nta_pre_non_on#_ion	nonpresentation_of_compound
und_mul_com_nd#_omp_#st_tim_f#c_#co_#of_mpo_d#s_oun_sti_lus_imu_ulu_pou_us#_of#	of_compound_stimulus
und_eme_nd#_ulu_s#e_#st_ele_mul_lem_#co_nts_mpo_d#s_oun_sti_lus_#el_men_ts#_com_omp_tim_ent_pou_imu_us#	compound_stimulus_elements
eme_Tan_ulu_s#e_#st_ele_mul_nul_lem_#Ta_nts_#el_sti_lus_men_ts#_anu_tim_ent_ul#_imu_s#T_us#	stimulus_elements_Tanul
anu_nul_lem_eme_Tan_l#s_ent_#Ta_nts_ul#_#s#_#el_s#T_men_ele_ts#	elements_Tanul_s
anu_nul_Tan_l#s_ul#_#Ta_s#s_#s#	Tanul_s_s
mot_tiv_#mo_s#m_s#s_#s#_iv#_oti	s_s_motiv
mot_v#c_tiv_#mo_s#m_#s#_iv#_ci#_#ci_oti	s_motiv_ci
mot_cor_orl_v#c_esc_tiv_#mo_la#_Res_iv#_ci#_#Re_rla_#ci_i#R_oti_sco	motiv_ci_Rescorla
cor_orl_a#R_esc_la#_Res_ci#_#R#_#Re_rla_#ci_i#R_sco	ci_Rescorla_R
orl_a#R_esc_la#_Res_#R#_#Re_rla_cor_#A#_R#A_sco	Rescorla_R_A
A#s_#s#_#R#_#A#_R#A	R_A_s
s#W_agn_Wag_ner_er#_A#s_#s#_#A#_gne_#Wa	A_s_Wagner
s#W_r#A_agn_Wag_ner_er#_#s#_#A#_gne_#Wa	s_Wagner_A
r#A_agn_Wag_ner_er#_#R#_#A#_A#R_gne_#Wa	Wagner_A_R
A#R_#R#_R#A_#A#	A_R_A
avl_vi#_vlo_ovi_#pa_#R#_R#A_lov_#A#_pav_A#p	R_A_pavlovi
cio_avl_vi#_vlo_ond_ovi_ici_#ko_#pa_on#_i#k_lov_pav_#A#_kon_dic_ndi_A#p_ion	A_pavlovi_kondicion
cio_avl_vi#_vlo_n#l_ond_ovi_ici_#ko_#pa_i#k_lov_pav_on#_kon_dic_ndi_#l#_ion	pavlovi_kondicion_l
cio_n#l_ond_ici_l#s_#ko_#s#_on#_kon_dic_ndi_#l#_ion	kondicion_l_s
l#s_#te_#s#_te#_#l#_s#t	l_s_te
ri#_#te_#ri_#s#_e#r_te#_s#t	s_te_ri
ri#_i#j_#ja_#te_#ri_e#r_te#_ja#	te_ri_ja
a#V_ri#_#Va_i#j_#ja_#ri_ari_ja#_Var	ri_ja_Vari
a#V_ri#_#Va_#ja_ari_ci#_i#c_#ci_ja#_Var	ja_Vari_ci
ri#_#k#_#Va_ari_ci#_i#k_i#c_#ci_Var	Vari_ci_k
#k#_#a#_ci#_k#a_i#k_#ci	ci_k_a
#k#_#ha_#a#_k#a_hat_at#_a#h	k_a_hat
ys#_#ha_#ko_#a#_kon_ony_nys_hat_at#_a#h_t#k	a_hat_konys
ys#_#ha_#ko_kon_ony_nys_hat_#g#_at#_s#g_t#k	hat_konys_g
g#s_ys#_#ko_#s#_nys_ony_kon_s#g_#g#	konys_g_s
g#s_#ha_s#h_#s#_hat_at#_#g#	g_s_hat
ans_ala_ns#_nyt_yta_tal_#ha_s#h_#ko_#s#_kon_ony_lan_hat_at#_t#k	s_hat_konytalans
ans_ala_ns#_nyt_yta_tal_#ha_#ko_kon_ony_lan_hat_#g#_at#_s#g_t#k	hat_konytalans_g
ans_hat_ala_ns#_nyt_yta_tal_#ha_#ko_lan_ony_g#h_kon_at#_s#g_#g#	konytalans_g_hat
#ha_#s#_t#s_g#h_hat_at#_#g#	g_hat_s
#r#_#ha_s#r_#s#_t#s_hat_at#	hat_s_r
#r#_#s#_r#l_s#r_#l#	s_r_l
zik_ssz_las_kus_#r#_ass_#Kl_szi_Kla_l#K_r#l_iku_us#_#l#	r_l_Klasszikus
zik_ond_#Kl_iku_#l#_kus_#ko_szi_dic_ndi_Kla_cio_las_ass_s#k_kon_ssz_ici_l#K_on#_us#_ion	l_Klasszikus_kondicion
zik_ond_#Kl_iku_#l#_kus_#ko_szi_n#l_dic_ndi_Kla_cio_las_ass_s#k_kon_ssz_ici_on#_us#_ion	Klasszikus_kondicion_l
cio_n#l_ond_ici_l#s_#ko_#s#_on#_kon_dic_ndi_#l#_ion	kondicion_l_s
s#I_l#s_#s#_#II_#l#_II#	l_s_II
s#I_#s#_I#A_#A#_#II_II#	s_II_A
A#H_#A#_I#A_#II_#H#_II#	II_A_H
lac_#Bl_Bla_H#B_ck#_A#H_#A#_#H#_ack	A_H_Black
lac_#Bl_Bla_H#B_ck#_#s#_k#s_#H#_ack	H_Black_s
lac_#Bl_s#W_Bla_#s#_k#s_#W#_ck#_ack	Black_s_W
s#W_W#F_#F#_#s#_#W#	s_W_F
#Pr_W#F_oka_F#P_asy_kas_Pro_sy#_#F#_rok_#W#	W_F_Prokasy
#Pr_Sze_oka_F#P_asy_kas_Pro_sy#_erk_#F#_rk#_y#S_zer_rok_#Sz	F_Prokasy_Szerk
k#P_#Pr_Sze_oka_asy_sy#_kas_Pro_erk_rk#_y#S_zer_rok_Pp#_#Sz_#Pp	Prokasy_Szerk_Pp
k#P_App_eto_ppl_Sze_ton_erk_ple_rk#_on#_let_zer_p#A_#Ap_Pp#_#Sz_#Pp	Szerk_Pp_Appleton
tur_ry#_App_eto_ppl_#Ce_ton_ple_ent_ntu_on#_ury_let_Cen_#Ap_p#A_n#C_Pp#_#Pp	Pp_Appleton_Century
tur_ntu_let_Cen_y#C_Cro_fts_#Ap_ts#_oft_App_eto_ppl_ton_#Cr_ent_rof_n#C_#Ce_ple_ury_on#_ry#	Appleton_Century_Crofts
tur_oft_#Ce_Cro_s#K_ntu_ent_#Cr_ury_fts_Cen_rof_#K#_y#C_ts#_ry#	Century_Crofts_K
oft_Cro_ls#_s#K_#Cr_fts_K#l_rof_#ls_#K#_ts#	Crofts_K_ls
koz_ls#_iva_hiv_s#h_vat_K#l_tko_#hi_#ls_#K#_atk_oz#	K_ls_hivatkoz
ok#_#so_sok_ls#_iva_hiv_s#h_vat_tko_#hi_#ls_koz_atk_oz#_z#s	ls_hivatkoz_sok
ok#_#sz_sze_esz_oz#_sok_hiv_kes_tko_zer_zt#_#hi_atk_erk_koz_#so_iva_rke_vat_szt_k#s_z#s	hivatkoz_sok_szerkeszt
ok#_#sz_sok_#so_rke_erk_kes_sze_esz_szt_#s#_k#s_zer_zt#_t#s	sok_szerkeszt_s
#sz_sze_esz_arp_rpe_ia#_kes_zer_zt#_hol_dia_cho_#Sc_s#S_erk_#s#_t#s_edi_ola_rke_ped_szt_Sch_lar	szerkeszt_s_Scholarpedia
rpe_arp_rla_ia#_sco_orl_esc_hol_cor_dia_cho_#Sc_s#S_a#R_la#_#s#_edi_ola_ped_Sch_lar_Res_#Re	s_Scholarpedia_Rescorla
ner_Wag_rpe_arp_rla_ia#_sco_orl_esc_er#_hol_cor_dia_cho_a#W_#Sc_a#R_agn_la#_edi_ola_ped_Sch_lar_Res_#Re_gne_#Wa	Scholarpedia_Rescorla_Wagner
ner_Wag_#mo_del_rla_sco_orl_esc_er#_mod_cor_ell_a#W_ode_agn_la#_r#m_ll#_Res_#Re_gne_#Wa	Rescorla_Wagner_modell
r#m_ode_agn_Wag_ner_er#_#mo_ll#_del_l#F_#Fo_rr#_orr_mod_For_gne_#Wa_ell	Wagner_modell_Forr
ok#_ode_#so_sok_l#F_#mo_ll#_del_#Fo_orr_mod_r#s_For_rr#_ell	modell_Forr_sok
ok#_#so_sok_#sz_rke_erk_kes_sze_esz_#Fo_szt_k#s_zer_orr_r#s_zt#_For_rr#	Forr_sok_szerkeszt
ok#_#sz_sok_#so_rke_erk_kes_sze_esz_szt_#s#_k#s_zer_zt#_t#s	sok_szerkeszt_s
#Ug_gr#_#sz_rke_erk_kes_sze_esz_szt_#s#_zer_t#s_zt#_s#U_Ugr	szerkeszt_s_Ugr
#Ug_gr#_#s#_s#U_Ugr_r#s	s_Ugr_s
#Ug_gr#_el#_fel_#s#_s#f_r#s_Ugr_#fe	Ugr_s_fel
#Mi_l#M_Mil_ill_el#_ler_er#_lle_fel_#s#_s#f_#fe	s_fel_Miller
#Mi_l#M_Mil_ill_el#_r#R_#Ra_lph_ler_er#_lle_fel_ph#_alp_Ral_#fe	fel_Miller_Ralph
#Mi_Mil_r#R_ill_h#R_#Ra_lph_ler_er#_lle_ph#_#R#_alp_Ral	Miller_Ralph_R
R#B_h#R_#Ra_lph_net_#Ba_ph#_#R#_alp_Ral_arn_et#_rne_Bar	Ralph_R_Barnet
R#B_t#R_ber_net_#Ro_Rob_ert_#Ba_#R#_obe_arn_et#_rt#_rne_Bar	R_Barnet_Robert
t#R_ber_net_#Ro_Rob_ert_t#C_#Ba_#C#_obe_arn_et#_rt#_rne_Bar	Barnet_Robert_C
#Gr_ber_Rob_ert_#Ro_t#C_C#G_ame_obe_rt#_rah_#C#_me#_aha_ham_Gra	Robert_C_Grahame
#Gr_las_ola_e#N_Nic_as#_C#G_ich_ame_#Ni_me#_rah_#C#_hol_aha_ham_Gra_cho	C_Grahame_Nicholas
#Gr_las_ola_Nic_as#_ich_ame_#Ni_s#J_#J#_me#_hol_rah_e#N_ham_aha_Gra_cho	Grahame_Nicholas_J
as#_#J#_sse_ssm_nt#_s#J_#As_Nic_Ass_#Ni_ses_hol_men_cho_las_ent_ich_J#A_sme_ess_ola	Nicholas_J_Assessment
#As_t#o_of#_ent_#of_Ass_sme_#J#_sse_ses_ssm_nt#_men_J#A_ess	J_Assessment_of
#As_t#o_of#_#th_he#_ent_#of_Ass_sme_ssm_sse_ses_nt#_f#t_men_the_ess	Assessment_of_the
e#R_orl_sco_he#_#th_esc_#of_la#_Res_#Re_rla_cor_f#t_the_of#	of_the_Rescorla
e#R_orl_a#W_he#_agn_#th_esc_Wag_ner_er#_la#_Res_#Re_rla_cor_gne_the_#Wa_sco	the_Rescorla_Wagner
ner_Wag_del_rla_sco_orl_el#_esc_er#_cor_a#W_ode_agn_la#_#Mo_Res_r#M_#Re_gne_Mod_#Wa	Rescorla_Wagner_Model
syc_l#P_ner_Wag_gic_del_cal_Psy_el#_ogi_er#_hol_al#_cho_ode_agn_olo_ych_#Mo_r#M_ica_gne_log_Mod_#Wa_#Ps	Wagner_Model_Psychological
syc_l#P_gic_del_cal_#Bu_let_l#B_Psy_tin_el#_hol_al#_cho_ode_ull_eti_Bul_olo_in#_log_ych_#Mo_lle_ica_ogi_Mod_#Ps	Model_Psychological_Bulletin
Ame_syc_mer_gic_cal_#Bu_let_l#B_Psy_tin_ric_eri_hol_al#_n#A_cho_ull_eti_Bul_an#_olo_in#_log_ych_lle_ica_ogi_#Am_#Ps_can	Psychological_Bulletin_American
Ame_syc_mer_gic_cal_#Bu_let_Psy_tin_n#P_ric_ogi_eri_hol_n#A_al#_cho_ull_eti_Bul_an#_olo_in#_ych_lle_ica_log_#Am_#Ps_can	Bulletin_American_Psychological
oci_ati_Ame_syc_mer_gic_cal_l#A_Psy_n#P_soc_#As_ric_cia_iat_Ass_eri_hol_al#_cho_tio_sso_an#_olo_log_ych_on#_ica_ogi_#Am_#Ps_ion_can	American_Psychological_Association
oci_ati_syc_doi_gic_cal_l#A_Psy_soc_#As_oi#_cia_iat_Ass_hol_al#_cho_tio_sso_olo_n#d_log_ych_on#_ica_#do_ogi_#Ps_ion	Psychological_Association_doi
oci_ati_soc_n#d_#As_oi#_cia_tio_iat_doi_i#P_sso_Ass_#PM_PMI_#do_on#_MID_ion_ID#	Association_doi_PMID
#Ug_gr#_oi#_doi_#PM_i#P_D#U_PMI_#do_Ugr_MID_ID#	doi_PMID_Ugr
#Ug_gr#_#PM_D#U_#s#_PMI_Ugr_r#s_MID_ID#	PMID_Ugr_s
#Ug_gr#_el#_fel_#s#_s#f_r#s_Ugr_#fe	Ugr_s_fel
#Va_el#_fel_l#V_#s#_s#f_Van_an#_#fe	s_fel_Van
Ham_mme_#Va_el#_l#V_fel_amm_n#H_Van_an#_#Ha_me#_#fe	fel_Van_Hamme
Ham_mme_#Va_n#H_Van_#L#_an#_#Ha_me#_e#L_amm	Van_Hamme_L
Ham_mme_L#J_#L#_#J#_me#_#Ha_e#L_amm	Hamme_L_J
rma_J#W_ass_Was_man_L#J_#J#_#L#_sse_erm_an#_ser_#Wa	L_J_Wasserman
rma_J#W_ass_Was_man_#E#_#J#_sse_erm_an#_n#E_ser_#Wa	J_Wasserman_E
rma_ass_Was_man_#E#_sse_erm_an#_E#A_#A#_n#E_ser_#Wa	Wasserman_E_A
Cue_A#C_#Cu_#E#_#A#_E#A_ue#	E_A_Cue
Cue_com_A#C_e#c_omp_eti_tio_#Cu_#co_pet_mpe_#A#_on#_tit_ue#_ion_iti	A_Cue_competition
Cue_com_e#c_omp_eti_tio_#Cu_#co_pet_in#_#in_mpe_on#_tit_n#i_ue#_ion_iti	Cue_competition_in
cau_n#c_mpe_ali_#in_usa_tit_n#i_iti_aus_#co_pet_ity_com_ty#_omp_eti_tio_lit_in#_sal_on#_#ca_ion	competition_in_causality
cau_jud_eme_y#j_n#c_#ju_ali_usa_#in_aus_nts_ity_men_ts#_ty#_ent_gem_lit_sal_dge_in#_udg_#ca	in_causality_judgements
cau_jud_eme_y#j_#ju_ali_usa_aus_he#_nts_ity_men_The_ts#_ty#_ent_gem_lit_#Th_sal_dge_udg_s#T_#ca	causality_judgements_The
dge_jud_rol_le#_eme_he#_ent_nts_#ro_udg_#ju_gem_s#T_e#r_ole_#Th_men_The_ts#	judgements_The_role
rol_he#_e#o_#of_e#r_ole_le#_#Th_The_#ro_of#	The_role_of
ati_#no_ole_le#_ese_res_e#o_tat_f#n_of#_onp_sen_npr_tio_#of_ent_rol_nta_pre_non_on#_#ro_ion	role_of_nonpresentation
ati_onp_n#o_res_pre_nta_ese_non_npr_sen_tio_#of_ent_#no_tat_on#_f#n_ion_of#	of_nonpresentation_of
ati_und_nd#_#no_ese_res_#co_mpo_oun_tat_of#_onp_com_sen_npr_omp_tio_ent_#of_f#c_pou_n#o_nta_pre_non_on#_ion	nonpresentation_of_compound
und_mul_com_nd#_omp_#st_tim_f#c_#co_#of_mpo_d#s_oun_sti_lus_imu_ulu_pou_us#_of#	of_compound_stimulus
und_eme_nd#_ulu_s#e_#st_ele_mul_lem_#co_nts_mpo_d#s_oun_sti_lus_#el_men_ts#_com_omp_tim_ent_pou_imu_us#	compound_stimulus_elements
eme_ear_ing_ulu_arn_s#e_#st_ele_nin_mul_lem_us#_nts_#el_sti_lus_men_ts#_tim_ent_rni_s#L_Lea_ng#_imu_#Le	stimulus_elements_Learning
eme_nd#_ear_ing_arn_ele_nin_lem_nts_#el_men_ts#_and_g#a_ent_rni_s#L_Lea_ng#_#an_#Le	elements_Learning_and
ati_nd#_ear_ing_arn_nin_tiv_and_g#a_tio_rni_oti_Lea_Mot_iva_ng#_#an_#Mo_vat_on#_#Le_d#M_ion	Learning_and_Motivation
ati_and_nd#_Mot_iva_tio_tiv_n#A_#Mo_#an_vat_#A#_on#_oti_d#M_ion	and_Motivation_A
ati_lap_#la_iva_Mot_tio_tiv_n#A_#Mo_vat_ap#_#A#_on#_A#l_oti_ion	Motivation_A_lap
red_det_#la_#er_ede_p#e_ti#_eti_A#l_#A#_lap_ere_ap#	A_lap_eredeti
red_det_#la_#er_ede_p#e_ti#_#c#_eti_i#c_lap_ere_ap#	lap_eredeti_c
red_det_#c#_#er_ede_ti#_eti_c#m_i#c_me#_ere_#me	eredeti_c_me
#c#_tps_ttp_c#m_#ht_e#h_me#_ps#_htt_#me	c_me_https
#hu_tps_ttp_#ht_s#h_hu#_e#h_me#_ps#_htt_#me	me_https_hu
wik_#hu_edi_tps_ttp_ipe_dia_kip_#ht_s#h_ped_hu#_u#w_ps#_ia#_htt_iki_#wi	https_hu_wikipedia
wik_#hu_edi_#or_ipe_dia_org_kip_ped_hu#_u#w_rg#_ia#_a#o_iki_#wi	hu_wikipedia_org
wik_g#w_edi_#or_ipe_dia_org_kip_ped_#w#_rg#_ia#_a#o_iki_#wi	wikipedia_org_w
g#w_w#i_org_#or_ind_#w#_nde_ex#_rg#_#in_dex	org_w_index
w#i_ind_x#p_nde_#w#_ex#_hp#_#in_#ph_dex_php	w_index_php
le#_ind_tle_p#t_x#p_nde_ex#_#ti_tit_itl_hp#_#in_#ph_dex_php	index_php_title
e#R_cor_orl_le#_sco_tle_esc_p#t_#ti_la#_Res_#Re_itl_rla_hp#_tit_#ph_php	php_title_Rescorla
ner_Wag_itl_rla_le#_tit_sco_orl_esc_er#_cor_e#R_a#W_agn_#ti_la#_tle_Res_#Re_gne_#Wa	title_Rescorla_Wagner
ner_Wag_#mo_del_rla_sco_orl_esc_er#_mod_cor_ell_a#W_ode_agn_la#_r#m_ll#_Res_#Re_gne_#Wa	Rescorla_Wagner_modell
l#o_r#m_ode_#ol_ldi_agn_Wag_ner_er#_#mo_ll#_del_old_did_id#_mod_gne_#Wa_ell	Wagner_modell_oldid
Kat_d#K_l#o_ode_ldi_#ol_eg#_id#_old_did_#mo_ll#_del_teg_#Ka_mod_ate_ell	modell_oldid_Kateg
Kat_d#K_eg#_ldi_#ol_ria_id#_old_did_g#r_#ri_teg_#Ka_ia#_ate	oldid_Kateg_ria
ol#_Kat_eg#_iol_ria_g#r_#ri_teg_#Ka_ia#_#Bi_ate_a#B_Bio	Kateg_ria_Biol
ol#_iol_ria_#ri_ia#_gia_a#B_#Bi_l#g_#gi_Bio	ria_Biol_gia
ol#_Rej_ejt_jte_iol_tet_ett_a#R_#Re_gia_ia#_#Bi_l#g_#gi_tt#_Bio	Biol_gia_Rejtett
Rej_jte_ejt_kat_ett_tet_eg#_a#R_#ka_#Re_teg_gia_ia#_ate_#gi_tt#_t#k	gia_Rejtett_kateg
Rej_jte_ejt_kat_ett_tet_eg#_ri#_g#r_#ka_#ri_#Re_teg_ate_tt#_t#k	Rejtett_kateg_ri
eg#_kat_ri#_#k#_g#r_#ka_#ri_teg_i#k_ate	kateg_ri_k
ri#_#k#_es#_Pag_ges_#ri_#Pa_i#k_age_k#P	ri_k_Pages
#k#_es#_Pag_usi_ges_ng#_#us_#Pa_s#u_ing_sin_age_k#P	k_Pages_using
es#_Pag_usi_ges_ng#_#us_#PM_#Pa_s#u_ing_PMI_ID#_sin_age_MID_g#P	Pages_using_PMID
mag_usi_D#m_ng#_#us_#PM_agi_gic_ing_PMI_ID#_sin_ic#_MID_#ma_g#P	using_PMID_magic
mag_ink_ks#_#li_c#l_lin_D#m_agi_nks_#PM_gic_PMI_ic#_MID_#ma_ID#	PMID_magic_links
mag_ink_ks#_#Ko_#li_c#l_lin_s#K_rek_agi_nks_Kor_gic_ekt_rre_orr_kt#_ic#_#ma	magic_links_Korrekt
ink_ks#_#li_rek_lin_s#K_#r#_nks_Kor_ekt_rre_t#r_orr_kt#_#Ko	links_Korrekt_r
and_rek_#r#_nd#_r#z_Kor_ekt_#za_rre_t#r_zan_orr_kt#_#Ko	Korrekt_r_zand
#la_ok#_and_nd#_#r#_d#l_apo_r#z_#za_zan_lap_pok	r_zand_lapok
avi_#la_ok#_k#N_and_vig_nd#_d#l_apo_#za_ig#_Nav_#Na_zan_lap_pok	zand_lapok_Navig
avi_#la_ok#_k#N_vig_apo_ig#_Nav_#Na_#ci_ci#_g#c_lap_pok	lapok_Navig_ci
avi_ig#_#s#_Nav_#Na_#ci_ci#_g#c_vig_i#s	Navig_ci_s
s#m_#s#_ci#_#ci_i#s_men_#me_en#	ci_s_men
n#S_Sze_s#m_#s#_em#_men_#me_zem_#Sz_en#	s_men_Szem
n#S_es#_Sze_em#_lye_m#l_#ly_yes_men_#me_zem_#Sz_en#	men_Szem_lyes
es#_Sze_#es_zk#_szk_esz_em#_lye_m#l_#ly_s#e_yes_zem_#Sz	Szem_lyes_eszk
es#_k#z_#es_szk_esz_lye_#ly_s#e_yes_#z#_zk#	lyes_eszk_z
#k#_k#z_#es_z#k_szk_esz_zk#_#z#	eszk_z_k
k#N_#k#_#z#_em#_Nem_z#k_#Ne	z_k_Nem
k#N_#k#_#va_vag_gy#_em#_m#v_Nem_#Ne_agy	k_Nem_vagy
jel_y#b_vag_m#v_kez_#Ne_ele_eje_ve#_agy_zve_bej_#va_ent_gy#_em#_tke_#be_Nem_ezv_len_ntk	Nem_vagy_bejelentkezve
jel_ala_y#b_vag_kez_ele_ita_eje_ap#_ve#_agy_zve_bej_Vit_tal_#va_ent_gy#_tke_#be_ezv_e#V_#Vi_len_lap_ntk	vagy_bejelentkezve_Vitalap
jel_ala_p#K_kez_ele_ita_eje_ve#_zve_bej_Vit_tal_ent_len_tke_#be_#K#_ezv_e#V_#Vi_lap_ap#_ntk	bejelentkezve_Vitalap_K
#K#_rem_ita_Vit_ala_tal_K#z_#Vi_em#_lap_p#K_zre_ap#_#zr	Vitalap_K_zrem
rem_#k#_m#k_K#z_em#_#K#_zre_#zr	K_zrem_k
rem_#k#_m#k_em#_zre_#d#_k#d_#zr	zrem_k_d
#k#_#se_ek#_sek_d#s_#d#_k#d	k_d_sek
#se_ek#_sek_Fi#_d#s_k#F_#Fi_#d#	d_sek_Fi
#se_#k#_ek#_sek_Fi#_k#F_i#k_#Fi	sek_Fi_k
#k#_k#l_Fi#_i#k_#Fi_#l#	Fi_k_l
#k#_k#l_#tr_hoz_reh_eho_l#t_oz#_#l#_tre	k_l_trehoz
sa#_#tr_hoz_z#s_reh_eho_#sa_l#t_oz#_#l#_tre	l_trehoz_sa
jel_#tr_eho_#sa_kez_oz#_ele_Bej_tre_eje_hoz_ent_a#B_tke_reh_#Be_sa#_ez#_len_z#s_ntk	trehoz_sa_Bejelentkez
jel_sa#_eje_z#s_ent_ele_#s#_ez#_len_#sa_tke_kez_a#B_Bej_#Be_ntk	sa_Bejelentkez_s
jel_Bej_eje_z#s_#N#_ent_#s#_ez#_len_s#N_tke_kez_ele_#Be_ntk	Bejelentkez_s_N
vte_rek_#vt_ek#_#N#_ter_#s#_s#N_N#v_ere	s_N_vterek
vte_rek_k#S_#vt_ek#_#N#_ter_Sz#_N#v_ere_#Sz	N_vterek_Sz
vte_rek_k#S_#vt_ek#_ter_Sz#_z#c_ikk_kk#_#ci_cik_ere_#Sz	vterek_Sz_cikk
ita_Vit_ala_kk#_ikk_Sz#_tal_z#c_ap#_k#V_#Vi_#ci_cik_lap_#Sz	Sz_cikk_Vitalap
ita_Vit_ala_kk#_ikk_#V#_tal_ap#_k#V_#Vi_p#V_#ci_cik_lap	cikk_Vitalap_V
lto_ita_ok#_Vit_ala_#V#_V#l_tal_tok_#Vi_oza_p#V_toz_lap_#lt_ato_ap#_zat	Vitalap_V_ltozatok
lto_k#N_ok#_#V#_V#l_#N#_tok_oza_toz_#lt_ato_zat	V_ltozatok_N
lto_k#N_ok#_zet_N#z_ek#_#N#_tok_oza_toz_#lt_ato_tek_zat_#ze_ete	ltozatok_N_zetek
vas_Olv_zet_N#z_ek#_#N#_k#O_as#_#Ol_lva_tek_#ze_ete	N_zetek_Olvas
vas_Olv_zet_ek#_as#_k#O_s#s_#s#_#Ol_lva_tek_#ze_ete	zetek_Olvas_s
vas_Olv_Sze_as#_s#S_erk_rke_s#s_kes_esz_#s#_#Ol_zer_szt_zt#_lva_#Sz	Olvas_s_Szerkeszt
Sze_s#S_erk_rke_kes_esz_szt_#s#_zer_t#s_zt#_#Sz	s_Szerkeszt_s
#La_apt_pt#_Sze_rke_erk_kes_esz_szt_#s#_zer_t#s_zt#_Lap_s#L_#Sz	Szerkeszt_s_Lapt
#La_apt_pt#_#s#_t#r_Lap_#rt_rt#_s#L	s_Lapt_rt
#La_apt_pt#_t#n_net_#rt_t#r_Lap_#ne_rt#_et#	Lapt_rt_net
t#n_#T#_net_t#T_#rt_#ne_rt#_et#	rt_net_T
T#b_#T#_net_t#T_bb#_#ne_et#_#bb	net_T_bb
res_es#_T#b_#T#_Ker_bb#_#Ke_#bb_ere_b#K	T_bb_Keres
res_es#_Ker_s#s_bb#_#s#_#Ke_#bb_ere_b#K	bb_Keres_s
avi_res_es#_Ker_s#s_ig#_#s#_Nav_#Na_#Ke_vig_s#N_ere	Keres_s_Navig
avi_ig#_#s#_Nav_#Na_#ci_ci#_g#c_vig_s#N	s_Navig_ci
avi_zd#_i#K_Kez_ig#_Nav_#Na_#ci_ci#_g#c_vig_#Ke_ezd	Navig_ci_Kezd
#la_zd#_d#l_i#K_ap#_Kez_ci#_#Ke_ezd_#ci_lap	ci_Kezd_lap
#la_rta_zd#_d#l_art_Tar_tal_Kez_#Ta_alo_lom_om#_#Ke_ezd_lap_ap#_p#T	Kezd_lap_Tartalom
Kie_#la_rta_elt_eme_art_Tar_tal_alo_#Ta_lom_om#_m#K_#Ki_mel_lt#_lap_iem_ap#_p#T	lap_Tartalom_Kiemelt
Kie_rta_eme_#sz_art_Tar_tal_alo_#Ta_lom_om#_m#K_#Ki_mel_t#s_lt#_sz#_elt_iem	Tartalom_Kiemelt_sz
kek_Kie_eme_#sz_ikk_ek#_z#c_sz#_#Ki_mel_t#s_lt#_kke_#ci_cik_elt_iem	Kiemelt_sz_cikkek
kek_ss#_#sz_ikk_ek#_z#c_sz#_k#F_ris_iss_kke_#ci_cik_#Fr_Fri	sz_cikkek_Friss
kek_#v#_ss#_ikk_ek#_s#v_k#F_ris_iss_kke_#ci_cik_#Fr_Fri	cikkek_Friss_v
lto_#v#_ss#_ozt_zta_v#l_s#v_at#_ris_iss_Fri_toz_#lt_#Fr_tat	Friss_v_ltoztat
lto_#v#_ok#_ozt_#so_sok_zta_v#l_t#s_toz_tat_#lt_at#	v_ltoztat_sok
lto_#La_ok#_ozt_#so_sok_zta_k#L_t#s_Lap_toz_tat_#lt_at#_ap#	ltoztat_sok_Lap
#La_ok#_sok_#so_tal_p#t_k#L_Lap_#ta_al#_ap#	sok_Lap_tal
#La_#lo_ra#_tal_p#t_lom_l#l_omr_Lap_mra_#ta_al#_ap#	Lap_tal_lomra
Tud_uda_#lo_a#T_ra#_tal_lom_l#l_omr_mra_ako_#ta_al#_koz_dak_oz#_#Tu	tal_lomra_Tudakoz
Tud_uda_#lo_a#T_ra#_z#R_lom_omr_ako_#R#_mra_koz_dak_oz#_#Tu	lomra_Tudakoz_R
Tud_R#s_#sz_z#R_szv_zv#_ako_#R#_uda_koz_dak_oz#_#Tu	Tudakoz_R_szv
tel_#sz_szv_el#_v#t_#te_#R#_R#s_zv#	R_szv_tel
tel_zd#_#sz_szv_el#_v#t_#te_Kez_l#K_#Ke_ezd_zv#	szv_tel_Kezd
tel_zd#_el#_ek#_#te_Kez_l#K_#Ke_ezd_d#k_#kn_kne_nek	tel_Kezd_knek
zd#_eg#_k#S_ek#_Kez_#Ke_ezd_#kn_d#k_kne_nek_#Se_Seg	Kezd_knek_Seg
eg#_k#S_ek#_g#t_kne_#kn_nek_#Se_#ts_ts#_Seg	knek_Seg_ts
eg#_g#t_#Se_#g#_#ts_s#g_ts#_Seg	Seg_ts_g
g#K_#K#_#ts_s#g_ts#_#g#	ts_g_K
K#z_g#K_#K#_#z#_#g#	g_K_z
ss#_#ss_K#z_#K#_#z#_z#s	K_z_ss
#ss_gi#_ss#_#z#_#gi_s#g_z#s	z_ss_gi
#ss_gi#_por_#po_i#p_rt#_ss#_#gi_s#g_ort	ss_gi_port
por_gi#_#po_i#p_rt#_t#l_#gi_#l#_ort	gi_port_l
elv_Kap_sol_lat_ola_atf_cso_por_tfe_#po_fel_lv#_l#K_rt#_#Ka_pcs_t#l_apc_#l#_ort	port_l_Kapcsolatfelv
elv_tel_Kap_sol_lat_ola_atf_el#_cso_v#t_#te_tfe_fel_lv#_l#K_#Ka_pcs_apc_#l#	l_Kapcsolatfelv_tel
elv_lat_Ado_tfe_lv#_l#A_el#_cso_#te_fel_#Ka_pcs_apc_dom_Kap_sol_atf_om#_tel_ola_v#t_#Ad	Kapcsolatfelv_tel_Adom
yok_ok#_tel_el#_Ado_nyo_#te_om#_#Ad_m#n_#ny_dom_l#A	tel_Adom_nyok
yok_ok#_k#N_nyo_Ado_mta_#Ny_omt_om#_Nyo_tat_#Ad_at#_m#n_#ny_dom_yom	Adom_nyok_Nyomtat
k#N_ok#_yok_nyo_mta_#Ny_omt_Nyo_#s#_t#s_tat_at#_#ny_yom	nyok_Nyomtat_s
exp_#ex_mta_#Ny_por_Nyo_#s#_t#s_rt#_tat_s#e_at#_xpo_omt_yom_ort	Nyomtat_s_export
exp_#ex_por_#s#_rt#_s#e_t#l_xpo_#l#_ort	s_export_l
exp_#ex_l#s_por_#s#_rt#_t#l_xpo_#l#_ort	export_l_s
l#s_s#K_#s#_#K#_#l#	l_s_K
s#K_nyv_yv#_#s#_#K#_#ny_K#n	s_K_nyv
#k#_nyv_yv#_#K#_#ny_v#k_K#n	K_nyv_k
#k#_#sz_nyv_yv#_sz#_k#s_#ny_v#k	nyv_k_sz
#k#_#sz_#t#_sz#_k#s_z#t	k_sz_t
#se_#t#_#sz_sz#_t#s_z#t_se#	sz_t_se
#se_#t#_Let_t#s_se#_et#_e#L_#Le	t_se_Let
#se_Let_lt#_se#_et#_t#l_e#L_#lt_#Le	se_Let_lt
Let_#s#_t#s_lt#_et#_#lt_#Le_t#l	Let_lt_s
PDF_#s#_t#s_lt#_s#P_#lt_DF#_#PD	lt_s_PDF
#k#_PDF_F#k_#s#_s#P_DF#_#PD	s_PDF_k
#k#_PDF_F#k_#nt_nt#_k#n_DF#_#PD	PDF_k_nt
t#E_#k#_#nt_Esz_szk_nt#_#Es_zk#_k#n	k_nt_Eszk
t#E_k#z_#nt_Esz_szk_nt#_#Es_zk#_#z#	nt_Eszk_z
#k#_k#z_z#k_Esz_szk_#Es_zk#_#z#	Eszk_z_k
Mi#_k#M_#Mi_#k#_#z#_z#k	z_k_Mi
Mi#_zik_k#M_#Mi_#k#_iva_i#h_hiv_ik#_vat_ozi_tko_#hi_koz_atk	k_Mi_hivatkozik
Mi#_zik_#Mi_k#e_#er_iva_hiv_i#h_ik#_vat_err_ozi_rre_tko_re#_#hi_koz_atk	Mi_hivatkozik_erre
zik_ik#_err_hiv_cso_tko_#Ka_pcs_#hi_apc_atk_ol#_k#e_#er_Kap_sol_e#K_re#_koz_iva_vat_ozi_rre	hivatkozik_erre_Kapcsol
ol#_#er_Kap_sol_cso_e#K_l#d_err_re#_rre_#Ka_pcs_apc_#d#	erre_Kapcsol_d
ol#_#v#_Kap_sol_cso_l#d_#Ka_pcs_apc_#d#_d#v	Kapcsol_d_v
lto_#v#_ozt_zta_v#l_toz_tat_#lt_at#_#d#_d#v	d_v_ltoztat
lto_#v#_ok#_ozt_#so_sok_zta_v#l_t#s_toz_tat_#lt_at#	v_ltoztat_sok
lto_ok#_#Sp_ozt_#so_sok_zta_k#S_Spe_ci#_t#s_pec_toz_tat_#lt_eci_at#	ltoztat_sok_Speci
lis_#Sp_ok#_sok_#so_k#S_i#l_#li_Spe_ci#_pec_eci_is#	sok_Speci_lis
lis_#Sp_#la_ok#_#li_i#l_s#l_apo_Spe_ci#_pec_eci_lap_is#_pok	Speci_lis_lapok
#la_lis_ok#_#li_Hiv_s#l_apo_iva_#Hi_vat_tko_lap_oz#_koz_atk_is#_k#H_pok	lis_lapok_Hivatkoz
#la_ok#_Hiv_apo_iva_#Hi_z#s_vat_#s#_tko_lap_koz_atk_oz#_k#H_pok	lapok_Hivatkoz_s
#er_Hiv_iva_z#s_vat_err_#s#_rre_tko_re#_s#e_koz_atk_oz#_#Hi	Hivatkoz_s_erre
#er_err_e#a_#s#_rre_re#_#a#_s#e	s_erre_a
#v#_#er_err_e#a_re#_rre_#a#_a#v	erre_a_v
lto_#v#_zat_atr_ra#_v#l_tra_#a#_oza_toz_#lt_a#v	a_v_ltozatra
lto_#La_#v#_atr_ra#_for_orm_v#l_tra_a#L_oza_Lap_api_toz_nfo_#lt_rm#_inf_zat_pin	v_ltozatra_Lapinform
zat_pin_ra#_ci#_toz_inf_m#c_lto_orm_oza_api_rm#_#lt_nfo_#La_atr_for_tra_a#L_Lap_#ci	ltozatra_Lapinform_ci
#La_#k#_for_orm_m#c_ci#_Lap_#ci_api_nfo_rm#_i#k_inf_pin	Lapinform_ci_k
#k#_kid_k#W_ata_ci#_i#k_#Wi_#ci_ida_dat_iki_ta#_Wik	ci_k_Wikidata
atl_lap_#k#_kid_ap#_k#W_ata_a#a_ada_#Wi_tla_ida_dat_iki_#ad_ta#_Wik	k_Wikidata_adatlap
gya_a#a_#Ho_p#H_tla_dat_atl_kid_Wik_yan_ata_ada_an#_#Wi_ida_iki_ta#_ogy_lap_Hog_ap#_#ad	Wikidata_adatlap_Hogyan
gya_#Ho_p#H_tla_dat_atl_ozz_n#h_hiv_tko_#hi_atk_yan_zz#_ada_an#_koz_iva_ogy_vat_lap_Hog_ap#_#ad	adatlap_Hogyan_hivatkozz
gya_err_#Ho_n#h_hiv_tko_#hi_atk_#er_yan_zz#_re#_an#_koz_iva_ogy_z#e_vat_rre_Hog_ozz	Hogyan_hivatkozz_erre
#er_iva_hiv_z#e_vat_err_zz#_rre_re#_tko_e#a_#a#_#hi_koz_atk_ozz	hivatkozz_erre_a
#la_#er_apr_pra_ra#_err_e#a_re#_rre_#a#_lap_a#l	erre_a_lapra
#la_apr_pra_ra#_#M#_#a#_a#M_lap_a#l	a_lapra_M
#la_apr_pra_ra#_#M#_#s#_M#s_a#M_lap	lapra_M_s
elv_vek_#M#_#s#_M#s_s#n_yel_eke_lve_#ny_ken_en#_nye	M_s_nyelveken
lis_elv_#En_ngl_Eng_gli_vek_ish_#s#_s#n_yel_eke_lve_n#E_#ny_ken_sh#_en#_nye	s_nyelveken_English
elv_gli_ch#_lve_sh#_Deu_Eng_vek_yel_eke_#En_lis_h#D_uts_ish_#De_sch_n#E_ken_tsc_ngl_eut_#ny_en#_nye	nyelveken_English_Deutsch
lis_h#F_h#D_gli_ngl_Eng_uts_tsc_ran_ish_ch#_#De_Fra_eut_an#_sch_#Fr_sh#_Deu_#En	English_Deutsch_Fran
ais_h#F_tsc_uts_ran_n#a_ch#_#De_Fra_eut_an#_sch_#Fr_#ai_is#_Deu	Deutsch_Fran_ais
ais_ede_ran_and_n#a_der_Ned_nds_erl_Fra_lan_#Ne_an#_rla_ds#_s#N_#Fr_#ai_is#	Fran_ais_Nederlands
nds_Lin_rla_s#N_#Ne_is#_kek_#ai_ais_ink_and_der_ek#_Ned_erl_ds#_nke_s#L_ede_lan_#Li	ais_Nederlands_Linkek
#sz_nds_Lin_sze_esz_rla_#Ne_kek_kes_zer_zt#_ink_and_der_ek#_Ned_erk_erl_ds#_nke_s#L_ede_rke_szt_lan_k#s_#Li	Nederlands_Linkek_szerkeszt
kek_ink_#se_#sz_#Li_ek#_erk_rke_Lin_kes_sze_esz_szt_k#s_zer_zt#_t#s_nke_se#	Linkek_szerkeszt_se
e#A_#se_#sz_rke_erk_kes_sze_esz_szt_zer_t#s_zt#_se#_#A#	szerkeszt_se_A
lap_#la_e#A_#se_ap#_#A#_se#_A#l	se_A_lap
#la_p#u_tol_ls#_A#l_uto_#ut_#A#_lap_ols_ap#	A_lap_utols
#la_p#u_tol_#m#_ls#_uto_s#m_#ut_lap_ols_ap#	lap_utols_m
tol_#m#_ls#_uto_os#_s#m_dos_#ut_#do_ols_m#d	utols_m_dos
#m#_#t#_os#_dos_#do_s#t_m#d	m_dos_t
sa#_#t#_os#_dos_t#s_#do_#sa_s#t	dos_t_sa
sa#_#t#_okt_#ok_t#s_kt#_#sa_a#o	t_sa_okt
sa#_t#b_ber_er#_okt_#ok_kt#_#sa_a#o_#be	sa_okt_ber
r#A_ber_er#_okt_#ok_#A#_kt#_t#b_#be	okt_ber_A
#la_r#A_ber_ap#_er#_#A#_lap_#be_A#l	ber_A_lap
#la_#sz_A#l_p#s_sz#_#A#_lap_ap#	A_lap_sz
#la_veg_#sz_z#v_#ve_p#s_sz#_ege_lap_ge#_ap#	lap_sz_vege
Cre_ati_veg_#sz_z#v_rea_#Cr_eat_#ve_tiv_sz#_ege_ve#_ive_e#C_ge#	sz_vege_Creative
Cre_ati_Com_veg_ns#_#Co_rea_#Cr_eat_#ve_tiv_mmo_ege_ve#_ons_ive_e#C_ge#_mon_omm	vege_Creative_Commons
ati_rea_eat_e#C_s#N_#Ne_mon_omm_ns#_#Co_vez_tiv_ons_ve#_Nev_Cre_Com_zd#_#Cr_ezd_mmo_eve_ive	Creative_Commons_Nevezd
Com_d#m_zd#_eg#_omm_ns#_#Co_vez_eve_ons_#Ne_ezd_Nev_#me_s#N_meg_mon_mmo	Commons_Nevezd_meg
g#g_d#m_zd#_eg#_vez_eve_gy#_#me_ezd_Nev_meg_#Ne_#gy	Nevezd_meg_gy
add_eg#_gy#_y#a_#me_dd#_meg_g#g_#gy_#ad	meg_gy_add
add_tov_gy#_d#t_ov#_#to_dd#_y#a_#gy_#ad	gy_add_tov
add_tov_bb#_d#t_ov#_v#b_#to_dd#_#bb_#ad	add_tov_bb
enc_nc#_ice_#li_tov_bb#_v#b_#to_ov#_#bb_b#l_cen_lic	tov_bb_licenc
enc_nc#_ice_lat_#li_c#a_ala_att_bb#_#al_b#l_#bb_tt#_cen_lic	bb_licenc_alatt
enc_nc#_ice_lat_#li_c#a_ala_att_#va_t#v_#al_an#_van_tt#_cen_lic	licenc_alatt_van
#eg_lat_ala_es#_att_#va_n#e_egy_t#v_gye_#al_an#_yes_van_tt#	alatt_van_egyes
#eg_ben_es#_#es_set_egy_#va_n#e_gye_ekb_kbe_an#_s#e_yes_ese_van_tek_en#_ete	van_egyes_esetekben
#eg_ben_es#_#m#_#es_n#m_set_egy_kbe_gye_ekb_s#e_yes_ese_tek_en#_ete	egyes_esetekben_m
ben_#m#_#es_n#m_m#s_set_kbe_ekb_#s#_ese_tek_en#_ete	esetekben_m_s
m#s_#s#_s#m_#m#	m_s_m
don_#m#_s#m_#s#_#do_on#_m#d	s_m_don
don_#m#_#do_on#_is#_n#i_#is_m#d	m_don_is
don_lha_has_asz_szn_zn#_on#_fel_s#f_#do_#is_elh_#fe_is#_n#i	don_is_felhaszn
has_lha_asz_hat_szn_zn#_at#_fel_#lh_s#f_#is_n#l_elh_#fe_is#	is_felhaszn_lhat
has_lha_asz_hat_szn_zn#_t#R_at#_fel_#lh_#R#_n#l_elh_#fe	felhaszn_lhat_R
lha_#sz_t#R_szl_ek#_zle_#lh_let_#R#_R#s_hat_at#_tek_ete	lhat_R_szletek
k#r_#sz_szl_ek#_zle_let_#rt_#R#_rt#_R#s_tek_ete	R_szletek_rt
k#r_#sz_szl_ek#_zle_let_#rt_rt#_t#l_tek_#l#_ete	szletek_rt_l
#sd_l#s_#rt_rt#_sd#_t#l_#l#	rt_l_sd
d#a_#sd_l#s_#a#_sd#_#l#	l_sd_a
has_lha_asz_d#a_#sd_szn_zn#_a#f_fel_#a#_sd#_elh_#fe	sd_a_felhaszn
has_lha_asz_szn_zn#_a#f_fel_#a#_n#l_elh_#fe_#l#	a_felhaszn_l
has_lha_asz_si#_szn_zn#_l#s_fel_#si_n#l_elh_#fe_#l#	felhaszn_l_si
si#_l#s_fel_#si_lt#_i#f_#fe_elt_#l#	l_si_felt
tel_si#_#te_fel_#si_lt#_i#f_eke_ket_lek_#fe_elt_ele_t#t_et#	si_felt_teleket
bsp_tel_t#n_nbs_#te_sp#_fel_lt#_eke_ket_et#_lek_#fe_elt_ele_t#t_#nb	felt_teleket_nbsp
bsp_dat_tel_t#n_nbs_atv_#Ad_#te_sp#_Ada_eke_ket_et#_tv#_lek_p#A_ele_#nb	teleket_nbsp_Adatv
bsp_mi#_elm_nbs_v#d_atv_lmi_sp#_#de_del_Ada_#Ad_tv#_dat_p#A_#nb	nbsp_Adatv_delmi
mi#_elm_v#d_atv_lmi_#de_del_i#i_Ada_#Ad_tv#_dat_#ir_ir#	Adatv_delmi_ir
mi#_elm_elv_ek#_vek_#de_del_i#i_yel_r#n_lmi_lve_#ny_#ir_ir#_nye	delmi_ir_nyelvek
elv_ek#_vek_yel_r#n_#A#_lve_k#A_#ny_#ir_ir#_nye	ir_nyelvek_A
A#W_elv_Wik_ek#_vek_kip_yel_ip#_#A#_#Wi_lve_k#A_#ny_iki_nye	nyelvek_A_Wikip
A#W_p#d_#di_kip_di#_ip#_#Wi_#A#_iki_Wik	A_Wikip_di
p#d_#r#_#di_kip_di#_i#r_#Wi_ip#_iki_Wik	Wikip_di_r
#r#_#di_i#r_di#_r#l_#l#	di_r_l
l#J_#Jo_#r#_ogi_gi#_r#l_Jog_#l#	r_l_Jogi
l#J_#Jo_Jog_lat_zat_atk_nyi_ila_yil_gi#_oza_tko_ogi_at#_koz_#ny_#l#_i#n	l_Jogi_nyilatkozat
lat_nyi_les_gi#_esz_Jog_zat_t#F_#Jo_#Fe_tko_zt#_at#_atk_i#n_yil_oza_koz_jle_ila_szt_Fej_ogi_#ny_ejl	Jogi_nyilatkozat_Fejleszt
lat_nyi_les_esz_zat_t#F_#Fe_tko_zt#_at#_atk_yil_oza_koz_t#k_jle_#k#_ila_szt_Fej_#ny_ejl	nyilatkozat_Fejleszt_k
#S#_jle_#k#_k#S_les_#Fe_esz_szt_Fej_zt#_t#k_ejl	Fejleszt_k_S
tin_#k#_S#t_k#S_lat_iny_nyi_yil_ila_#ti_oza_tko_at#_koz_atk_zat_#S#	k_S_tinyilatkozat
lat_iny_nyi_zat_tin_S#t_tko_at#_atk_obi_yil_#ti_t#M_oza_Mob_koz_bil_ila_#Mo_il#_#S#	S_tinyilatkozat_Mobil
lat_iny_nyi_#n#_zat_tin_tko_at#_atk_obi_yil_#ti_t#M_oza_Mob_koz_bil_ila_#Mo_l#n_il#	tinyilatkozat_Mobil_n
zet_bil_#n#_obi_#Mo_Mob_et#_l#n_n#z_il#_#ze	Mobil_n_zet
bsp_t#n_nbs_zet_#n#_sp#_et#_n#z_#ze_#nb	n_zet_nbsp
bsp_t#n_nbs_zet_edi_Wik_sp#_p#W_kim_med_et#_#Wi_ia#_ime_iki_dia_#ze_#nb	zet_nbsp_Wikimedia
und_ati_Fou_sp#_a#F_#Fo_ia#_dat_ime_bsp_nbs_p#W_med_oun_dia_Wik_kim_#nb_tio_#Wi_iki_edi_on#_nda_ion	nbsp_Wikimedia_Foundation
und_ati_Fou_a#F_#Fo_ia#_dat_ime_n#P_Pow_med_oun_ed#_ere_dia_wer_Wik_kim_owe_tio_#Po_#Wi_iki_red_edi_on#_nda_ion	Wikimedia_Foundation_Powered
und_ati_Fou_#Fo_#by_dat_n#P_by#_Pow_oun_ed#_ere_wer_owe_tio_#Po_red_d#b_on#_nda_ion	Foundation_Powered_by
red_d#b_#Me_by#_y#M_edi_owe_Wik_#Po_Pow_ki#_iaW_ed#_aWi_#by_ere_dia_wer_iki_Med	Powered_by_MediaWiki
#Me_by#_y#M_edi_Wik_ki#_i#M_#M#_iaW_aWi_#by_iki_dia_Med	by_MediaWiki_M
#Me_edi_gse_Wik_ki#_i#M_#M#_iaW_M#g_aWi_se#_iki_dia_#gs_Med	MediaWiki_M_gse
Sze_rke_erk_kes_esz_#M#_szt_zer_M#g_e#S_se#_zt#_#Sz_#gs_gse	M_gse_Szerkeszt
Sze_rke_erk_kes_esz_szt_#s#_zer_e#S_zt#_se#_t#s_#Sz_#gs_gse	gse_Szerkeszt_s
Sze_rke_erk_#T#_kes_esz_szt_#s#_zer_t#s_zt#_s#T_#Sz	Szerkeszt_s_T
T#r_#T#_#s#_#rl_s#T_rl#	s_T_rl
T#r_l#s_#T#_#s#_#rl_rl#	T_rl_s
l#s_#s#_#rl_#El_El#_s#E_rl#	rl_s_El
#n#_#s#_#El_l#n_El#_s#E	s_El_n
zet_#n#_n#z_#El_et#_l#n_El#_#ze	El_n_zet
t#V_ssz_zet_#n#_sza_#Vi_iss_et#_Vis_n#z_za#_#ze	n_zet_Vissza
t#V_ssz_zet_#ll_sza_ll#_#Vi_iss_et#_Vis_a#l_za#_#ze	zet_Vissza_ll
ssz_#t#_#ll_sza_ll#_#Vi_iss_Vis_l#t_a#l_za#	Vissza_ll_t
#t#_#ll_ll#_#s#_t#s_l#t	ll_t_s
#t#_#s#_t#s_#A#_s#A	t_s_A
zet_#je_jeg_egy_A#j_#s#_gyz_#A#_s#A_et#_yze	s_A_jegyzet
zet_#je_#sz_egy_jeg_A#j_sz#_gyz_t#s_#A#_et#_yze	A_jegyzet_sz
veg_zet_#je_#sz_z#v_egy_jeg_#ve_sz#_ege_gyz_t#s_et#_ge#_yze	jegyzet_sz_vege
rta_maz_veg_#sz_lma_e#t_z#v_art_tal_alm_tar_#ve_sz#_ege_#ta_azh_ge#_at#_zha_hat	sz_vege_tartalmazhat
lma_ik#_tar_#ve_ege_ge#_#wi_wik_veg_alm_art_kik_at#_e#t_tal_iki_t#w_zha_rta_maz_#ta_azh_hat	vege_tartalmazhat_wikik
lma_ik#_tar_dot_#wi_wik_alm_art_kik_at#_k#d_tal_ot#_iki_t#w_zha_rta_maz_#do_#ta_azh_hat	tartalmazhat_wikik_dot
wik_t#N_kik_ik#_ot#_em#_dot_#do_#Ne_Nem_iki_#wi_k#d	wikik_dot_Nem
ker_m#s_t#N_er#_ot#_ike_em#_dot_#si_#do_sik_Nem_#Ne	dot_Nem_siker
ker_m#s_er#_ike_em#_#si_r#l_sik_lt#_#lt_Nem_#Ne	Nem_siker_lt
elm_ker_t#e_nti_ti#_er#_ike_ent_#si_#el_r#l_sik_lt#_#lt_lme_men	siker_lt_elmenti
elm_t#e_nti_ti#_i#a_ent_#a#_#el_lt#_#lt_lme_men	lt_elmenti_a
lme_det_#je_jeg_egy_#el_et#_men_elm_ti#_ent_#a#_nti_ted_a#j_ete_ede_zet_i#a_gyz_yze	elmenti_a_jegyzetedet
det_ede_al#_zet_#je_jeg_egy_tal_#a#_ted_gyz_et#_#ta_yze_a#j_t#t_ete	a_jegyzetedet_tal
det_ede_al#_zet_#je_#n#_egy_jeg_tal_ted_gyz_et#_#ta_l#n_yze_t#t_ete	jegyzetedet_tal_n
#sz_#n#_rke_tal_n#s_erk_kes_sze_esz_szt_zer_zt#_#ta_al#_l#n	tal_n_szerkeszt
si#_#sz_#n#_rke_n#s_erk_kes_sze_esz_szt_#si_zer_t#s_zt#	n_szerkeszt_si
si#_#sz_#tk_rke_erk_kes_sze_esz_szt_#si_zer_t#s_zt#_tk#_i#t	szerkeszt_si_tk
si#_k#z_#tk_#si_#z#_tk#_i#t	si_tk_z
k#z_#tk_#s#_#z#_tk#_z#s	tk_z_s
#mi_att_iat_s#m_#s#_mia_#z#_tt#_z#s	z_s_miatt
#mi_att_iat_s#m_t#M_#M#_#s#_mia_tt#	s_miatt_M
#mi_ld#_#so_sol_att_iat_old_t#M_#M#_M#s_mia_tt#	miatt_M_sold
ld#_sol_#so_#ki_old_ki#_#M#_M#s_d#k	M_sold_ki
ld#_sol_#so_#ki_i#a_old_ki#_#a#_d#k	sold_ki_a
#sz_#ki_i#a_ki#_sz#_#a#_a#s	ki_a_sz
veg_#sz_z#v_#ve_sz#_#a#_ege_get_et#_a#s	a_sz_veget
veg_#sz_z#v_#ve_az#_sz#_ege_t#a_get_et#_#az	sz_veget_az
veg_al#_#ve_az#_t#a_ege_get_et#_z#a_#az_#al	veget_az_al
bbi_l#b_bi#_az#_#al_z#a_al#_#az_#bb	az_al_bbi
bbi_l#b_#sz_rke_bi#_erk_kes_sze_esz_szt_zer_#al_zt#_al#_i#s_#bb	al_bbi_szerkeszt
bbi_akb_#sz_kb#_bla_rke_bi#_erk_kes_sze_esz_szt_t#a_zer_abl_zt#_lak_i#s_#bb_#ab	bbi_szerkeszt_ablakb
akb_#sz_kb#_bla_rke_erk_kes_sze_esz_szt_t#a_zer_abl_zt#_lak_b#l_#l#_#ab	szerkeszt_ablakb_l
akb_kb#_bla_l#s_#s#_abl_lak_b#l_#l#_#ab	ablakb_l_s
#k#_l#s_s#k_#s#_#l#	l_s_k
#k#_k#z_#zi_s#k_#s#_zi#	s_k_zi
#k#_k#z_#sz_rke_erk_kes_#zi_sze_esz_szt_zer_zt#_i#s_zi#	k_zi_szerkeszt
#sz_el#_#ss_rke_erk_kes_sze_#zi_esz_szt_zer_t#s_zt#_sse_i#s_zi#_sel	zi_szerkeszt_ssel
szd_#sz_ill_les_sze_esz_l#i_sse_#il_el#_kes_zer_zt#_zd#_#ss_erk_t#s_sel_rke_lle_szt	szerkeszt_ssel_illeszd
d#b_szd_zd#_ill_el#_#ss_les_lle_l#i_esz_be#_sse_sel_#be_#il	ssel_illeszd_be
d#b_szd_zd#_ill_les_lle_esz_be#_e#a_az#_#az_#be_#il	illeszd_be_az
lda_z#o_#ol_lra_ra#_old_az#_e#a_be#_#az_#be_alr_dal	be_az_oldalra
lda_z#o_#ol_lra_ra#_old_az#_#A#_#az_alr_dal_a#A	az_oldalra_A
lda_zet_#je_#ol_lra_ra#_old_jeg_egy_yze_A#j_gyz_#A#_et#_alr_dal_a#A	oldalra_A_jegyzet
zet_#je_egy_jeg_A#j_t#a_#a#_gyz_#A#_et#_yze	A_jegyzet_a
zet_#je_egy_jeg_t#a_#a#_gyz_et#_#CC_CC#_yze_a#C	jegyzet_a_CC
#a#_BY#_C#B_#CC_#BY_CC#_a#C	a_CC_BY
Y#S_BY#_C#B_#CC_#BY_CC#_#SA_SA#	CC_BY_SA
val_ami_ala_Y#S_int_#va_min_nt#_#SA_BY#_#BY_A#v_lam_SA#	BY_SA_valamint
val_ami_ala_int_#va_min_t#a_#a#_nt#_#SA_A#v_lam_SA#	SA_valamint_a
val_#GF_ami_GFD_ala_int_#va_min_a#G_t#a_#a#_DL#_nt#_FDL_lam	valamint_a_GFDL
#GF_GFD_#va_vag_a#G_DL#_#a#_gy#_L#v_FDL_agy	a_GFDL_vagy
#GF_GFD_#k#_y#k_#va_vag_DL#_gy#_L#v_FDL_agy	GFDL_vagy_k
#k#_y#k_#va_vag_gy#_#s#_k#s_agy	vagy_k_s
bbi_#k#_bi#_#s#_k#s_s#b_#bb	k_s_bbi
bbi_#v#_i#v_bi#_#s#_s#b_#bb	s_bbi_v
lto_bbi_#v#_i#v_bi#_v#l_ata_oza_toz_#lt_#bb_zat_ta#	bbi_v_ltozata
lto_#v#_lat_ala_att_v#l_ata_a#a_oza_#al_toz_#lt_tt#_zat_ta#	v_ltozata_alatt
lto_#le_lat_ala_att_les_ata_a#a_esz_oza_sz#_#al_toz_#lt_tt#_zat_ta#_t#l	ltozata_alatt_lesz
#le_lat_ala_#k#_att_les_esz_sz#_#al_t#l_z#k_tt#	alatt_lesz_k
#le_#k#_k#z_#zz_les_esz_sz#_zz#_z#k	lesz_k_zz
#k#_k#z_#t#_#zz_zz#_z#t	k_zz_t
#t#_#zz_#ve_zz#_ve#_z#t_t#v	zz_t_ve
#To_Tov_#t#_#ve_ve#_ov#_t#v_e#T	t_ve_Tov
#To_bbi_bi#_#ve_ve#_v#b_ov#_#bb_Tov_e#T	ve_Tov_bbi
#To_bbi_#r#_bi#_i#r_v#b_ov#_#bb_Tov	Tov_bbi_r
bbi_#sz_#r#_szl_bi#_i#r_zle_ek#_let_r#s_#bb_tek_ete	bbi_r_szletek
k#r_#sz_#r#_szl_ek#_zle_let_#rt_rt#_r#s_tek_ete	r_szletek_rt
k#r_#sz_szl_ek#_zle_let_#rt_rt#_t#l_tek_#l#_ete	szletek_rt_l
#sd_l#s_#rt_rt#_sd#_t#l_#l#	rt_l_sd
d#a_#sd_l#s_#a#_sd#_#l#	l_sd_a
has_lha_asz_d#a_#sd_szn_zn#_a#f_fel_#a#_sd#_elh_#fe	sd_a_felhaszn
has_lha_asz_szn_zn#_a#f_fel_#a#_n#l_elh_#fe_#l#	a_felhaszn_l
has_lha_asz_si#_szn_zn#_l#s_fel_#si_n#l_elh_#fe_#l#	felhaszn_l_si
si#_l#s_fel_#si_lt#_i#f_#fe_elt_#l#	l_si_felt
ink_tel_si#_#te_fel_ein_#si_lei_lt#_i#f_nke_ket_et#_#fe_elt_ele_t#t	si_felt_teleinket
ink_tel_t#j_#te_fel_ein_lei_#j#_lt#_ket_nke_et#_#fe_elt_ele_t#t	felt_teleinket_j
ink_tel_#k#_t#j_#te_ein_#j#_ket_et#_nke_j#k_ele_lei	teleinket_j_k
pje_#k#_zet_jeg_egy_#pj_#j#_gyz_et#_k#p_j#k_yze	j_k_pjegyzet
pje_Jel_#k#_zet_el#_jeg_egy_#pj_gyz_t#J_et#_k#p_yze_#Je	k_pjegyzet_Jel
pje_Jel_#lj_zet_el#_jeg_egy_#pj_l#l_lj#_gyz_t#J_et#_yze_#Je	pjegyzet_Jel_lj
#lj_Jel_el#_#ki_lj#_l#l_ki#_j#k_#Je	Jel_lj_ki
#lj_#eg_#ki_egy_lj#_ki#_i#e_gy#_j#k	lj_ki_egy
#eg_#t#_#ki_egy_i#e_ki#_gy#_y#t	ki_egy_t
t#g_#eg_#gl_#t#_ala_apo_gla_egy_ot#_gy#_lap_pot_lal_y#t	egy_t_glalapot
t#g_#gl_#t#_ala_apo_gla_ot#_t#a_#a#_lap_pot_lal	t_glalapot_a
ti#_#gl_ala_fen_apo_gla_a#f_ot#_ent_t#a_#a#_lap_nti_#fe_pot_lal	glalapot_a_fenti
ti#_#k#_fen_a#f_ent_#a#_i#k_nti_#fe	a_fenti_k
ti#_#pe_#k#_pen_fen_ent_i#k_k#p_nti_#fe_en#	fenti_k_pen
#pe_#k#_pen_n#a_#a#_k#p_en#	k_pen_a
#pe_pen_n#a_a#b_#a#_bal_#ba_al#_en#	pen_a_bal
#eg_eg#_a#b_l#e_#a#_bal_#ba_al#	a_bal_eg
#rg_#eg_eg#_rgo_l#e_g#r_bal_gom_omb_#ba_mb#_al#	bal_eg_rgomb
#rg_#eg_eg#_omv_nyo_rgo_art_g#r_tar_vat_ata_mb#_gom_omb_b#n_rt#_#ny_yom_mva	eg_rgomb_nyomvatart
#rg_omv_nyo_rgo_art_tar_vat_ata_#s#_mb#_gom_omb_b#n_rt#_t#s_#ny_yom_mva	rgomb_nyomvatart_s
val_omv_nyo_art_#va_tar_vat_ata_s#v_#s#_t#s_rt#_al#_#ny_yom_mva	nyomvatart_s_val
val_Ehh_#Eh_hez_l#E_#va_hhe_s#v_#s#_ez#_al#	s_val_Ehhez
val_Ehh_#Eh_hez_l#E_#va_hhe_#a#_ez#_z#a_al#	val_Ehhez_a
Ehh_#Eh_a#k_#k#_hez_hhe_#a#_ez#_z#a	Ehhez_a_k
a#k_#k#_hez_#a#_phe_ez#_k#p_#ph	a_k_phez
#k#_zet_#je_tek_hez_jeg_egy_ek#_phe_ez#_gyz_z#j_k#p_yze_#ph_ete	k_phez_jegyzetek
k#t_tar_yze_ak#_#je_art_hez_jeg_egy_ozn_phe_toz_ek#_z#j_#ph_rto_ete_nak_zet_zna_ez#_gyz_#ta_tek	phez_jegyzetek_tartoznak
k#t_tar_yze_ak#_k#H_#je_art_egy_jeg_ozn_toz_ek#_#H#_rto_ete_nak_zet_zna_gyz_#ta_tek	jegyzetek_tartoznak_H
nak_zd#_art_tar_ozn_zna_k#H_H#z_#zd_ak#_toz_#ta_#H#_rto	tartoznak_H_zd
zd#_d#a_#zd_az#_H#z_#az_#H#	H_zd_az
#eg_zd#_ret_d#a_ger_#zd_z#e_az#_ege_et#_#az_ere	zd_az_egeret
#eg_ret_ger_z#e_az#_t#a_ege_#a#_et#_#az_ere	az_egeret_a
a#k_#eg_ret_#k#_ger_t#a_ege_#a#_et#_ere	egeret_a_k
a#k_#p#_#k#_#a#_k#p	a_k_p
#p#_#k#_#f#_p#f_k#p	k_p_f
f#l_#p#_#f#_p#f_#l#	p_f_l
f#l_l#a_#f#_#a#_#l#	f_l_a
jel_l#a_gje_egj_a#m_#a#_len_meg_#me_ele_#l#_en#	l_a_megjelen
jel_gje_egj_#t#_a#m_#a#_n#t_len_meg_#me_ele_en#	a_megjelen_t
jel_gje_egj_#t#_#s#_n#t_t#s_len_meg_#me_ele_en#	megjelen_t_s
#kh_kh#_#t#_s#k_#s#_t#s	t_s_kh
h#z_#kh_kh#_s#k_#s#_#z#	s_kh_z
h#z_#kh_kh#_#A#_#z#_z#A	kh_z_A
zet_#je_ete_tet_jeg_egy_A#j_gyz_#A#_et#_#z#_yze_z#A	z_A_jegyzetet
zet_#je_tet_egy_jeg_A#j_t#a_#a#_gyz_#A#_et#_yze_ete	A_jegyzetet_a
zet_#je_tet_egy_jeg_a#z_t#a_#a#_gyz_et#_#z#_yze_ete	jegyzetet_a_z
#X#_a#z_#a#_#z#_z#X	a_z_X
lda_#ol_old_#X#_alo_X#o_lon_on#_#z#_z#X_dal	z_X_oldalon
dod_lda_udo_#tu_#ol_od#_old_#X#_alo_tud_X#o_lon_n#t_on#_dal	X_oldalon_tudod
zte_#sz_#ol_ni#_tud_lon_sze_esz_eni_dal_od#_alo_kes_d#s_n#t_zer_lda_udo_#tu_old_erk_ten_dod_rke_szt_on#	oldalon_tudod_szerkeszteni
Mi#_zte_#sz_ni#_tud_sze_esz_eni_od#_kes_d#s_zer_udo_#tu_erk_ten_dod_#Mi_rke_szt_i#M	tudod_szerkeszteni_Mi
Mi#_#Mi_zte_#sz_rke_erk_ni#_i#r_kes_sze_esz_szt_i#M_zer_#rt_rt#_eni_ten	szerkeszteni_Mi_rt
Mi#_#Mi_ret_#sz_etn_i#r_sze_#rt_t#s_zer_rt#_tn#_ere	Mi_rt_szeretn
n#d_ret_#sz_etn_sze_#rt_t#s_zer_rt#_tn#_ere_#d#	rt_szeretn_d
n#d_ret_#sz_etn_#t#_sze_zer_d#t_tn#_ere_#d#	szeretn_d_t
#t#_#r#_t#r_d#t_#d#	d_t_r
#t#_#r#_ni#_t#r_lni_r#l_#ln	t_r_lni
#r#_i#a_ni#_#a#_lni_r#l_#ln	r_lni_a
zet_#je_tet_i#a_ni#_jeg_egy_#a#_gyz_lni_et#_yze_a#j_#ln_ete	lni_a_jegyzetet
#Me_zet_#je_tet_jeg_egy_ent_t#M_#a#_gyz_nt#_et#_Men_yze_a#j_ete	a_jegyzetet_Ment
#Me_zet_#je_tet_egy_jeg_ent_t#M_#s#_gyz_nt#_t#s_et#_Men_yze_ete	jegyzetet_Ment_s
#Me_eg#_s#S_ent_#s#_nt#_t#s_#Se_Men_Seg	Ment_s_Seg
eg#_s#S_g#t_#s#_#Se_#ts_ts#_Seg	s_Seg_ts
eg#_g#t_#Se_#g#_#ts_s#g_ts#_Seg	Seg_ts_g
g#a_#a#_#ts_s#g_ts#_#g#	ts_g_a
a#k_#k#_g#a_#a#_#g#	g_a_k
pje_a#k_#k#_zet_jeg_egy_#pj_#a#_gyz_et#_k#p_yze	a_k_pjegyzet
pje_has_asz_#k#_zet_szn_zn#_jeg_egy_#ha_#pj_gyz_t#h_et#_k#p_yze	k_pjegyzet_haszn
pje_has_#la_asz_lat_zet_szn_zn#_jeg_egy_#ha_#pj_gyz_t#h_et#_n#l_at#_yze	pjegyzet_haszn_lat
has_#la_asz_lat_zn#_szn_hoz_#ha_t#h_n#l_at#_oz#_#ho	haszn_lat_hoz
#la_lat_hoz_t#h_#A#_at#_oz#_#ho_z#A	lat_hoz_A
A#f_#f#_hoz_#A#_oz#_#ho_z#A	hoz_A_f
#jl_A#f_#f#_f#j_hoz_jlh_lho_#A#_oz#	A_f_jlhoz
#jl_#k#_#f#_f#j_hoz_jlh_lho_z#k_oz#	f_jlhoz_k
pje_#jl_#k#_zet_hoz_jeg_egy_#pj_yze_jlh_lho_gyz_et#_k#p_z#k_oz#	jlhoz_k_pjegyzet
pje_zik_#k#_zet_art_jeg_egy_tar_#pj_ik#_ozi_gyz_rto_et#_k#p_#ta_toz_yze_t#t	k_pjegyzet_tartozik
k#G_zik_ik#_tar_yze_art_jeg_egy_et#_toz_#pj_rto_pje_Gtk_zet_ozi_gyz_#ta_tk#_#Gt_t#t	pjegyzet_tartozik_Gtk
k#G_zik_Gtk_art_dia_#di_ik#_tar_alo_log_ozi_ial_toz_#ta_og#_tk#_#Gt_rto_k#d	tartozik_Gtk_dialog
Gtk_dia_#di_alo_#in_fo#_ial_nfo_log_inf_og#_tk#_#Gt_g#i_k#d	Gtk_dialog_info
o#s_svg_#sv_#di_alo_vg#_#in_fo#_ial_log_inf_og#_dia_g#i_nfo	dialog_info_svg
o#s_svg_vg#_g#K_#sv_#K#_inf_#in_fo#_nfo	info_svg_K
pje_svg_zet_jeg_egy_vg#_#pj_gyz_g#K_K#p_et#_#sv_#K#_yze	svg_K_pjegyzet
pje_zet_t#m_#m#_jeg_egy_#pj_gyz_K#p_et#_#K#_yze	K_pjegyzet_m
pje_zet_#m#_jeg_egy_dos_#pj_os#_gyz_#do_et#_t#m_yze_m#d	pjegyzet_m_dos
#m#_#t#_os#_dos_#do_s#t_m#d	m_dos_t
#t#_os#_dos_#s#_t#s_#do_s#t	dos_t_s
#t#_hoz_s#h_#s#_t#s_oz#_#ho	t_s_hoz
oly_z#o_#ol_yan_hoz_s#h_#s#_an#_lya_oz#_#ho	s_hoz_olyan
oly_z#o_#ol_yan_hoz_n#b_an#_#b#_lya_oz#_#ho	hoz_olyan_b
#ol_yan_n#b_ng#_b#n_an#_#ng_#b#_lya_oly	olyan_b_ng
#sz_g#s_ng#_sz#_b#n_#ng_#b#	b_ng_sz
#sz_g#s_ng#_sz#_z#r_re#_#ng_#re	ng_sz_re
#sz_e#v_#va_sz#_z#r_re#_an#_van_#re	sz_re_van
e#v_#sz_n#s_#va_sz#_re#_an#_van_#re	re_van_sz
ks#_#sz_z#k_n#s_#va_#ks_sz#_an#_van	van_sz_ks
ks#_#sz_#ks_sz#_z#k_s#g_#g#	sz_ks_g
mi#_ks#_ami_g#a_#ks_#am_s#g_#g#	ks_g_ami
mi#_ami_g#a_#t#_#am_i#t_#g#	g_ami_t
mi#_ami_#t#_atj_oga_#mo_tja_mog_#am_gat_t#m_ja#_i#t	ami_t_mogatja
#t#_atj_oga_#mo_tja_a#a_#a#_mog_gat_t#m_ja#	t_mogatja_a
LHt_ttp_oga_#mo_Req_a#a_est_st#_XML_#XM_equ_ues_MLH_que_ja#_pRe_atj_tja_#a#_mog_tpR_Htt_a#X_gat	mogatja_a_XMLHttpRequest
LHt_ttp_ktu_Req_est_st#_XML_mot_#XM_equ_tum_ues_MLH_que_pRe_#ob_t#o_obj_ot#_ekt_#a#_bje_tpR_Htt_jek_umo_a#X	a_XMLHttpRequest_objektumot
LHt_ttp_ktu_Req_est_st#_XML_mot_#XM_equ_tum_ues_MLH_#A#_que_pRe_#ob_t#o_obj_ot#_ekt_bje_t#A_tpR_Htt_jek_umo	XMLHttpRequest_objektumot_A
#ob_mot_tum_jek_A#t_obj_ktu_umo_ekt_ot#_#te_bje_#A#_te#_t#A	objektumot_A_te
A#t_e#b_#te_#A#_te#_#b#	A_te_b
ng#_e#b_#te_b#n_#ng_te#_#b#	te_b_ng
#sz_g#s_ng#_sz#_b#n_#ng_#b#	b_ng_sz
#sz_g#s_ng#_sz#_z#d_#ng_#d#	ng_sz_d
#sz_sz#_z#d_#ne_em#_nem_#d#_d#n	sz_d_nem
m#t_#t#_em#_#ne_nem_#d#_d#n	d_nem_t
m#t_#t#_gat_atj_oga_#mo_tja_em#_#ne_mog_nem_t#m_ja#	nem_t_mogatja
#ez_#t#_atj_ezt_oga_#mo_tja_mog_zt#_gat_t#m_a#e_ja#	t_mogatja_ezt
#ez_atj_ezt_#az_oga_#mo_tja_az#_t#a_mog_zt#_gat_a#e_ja#	mogatja_ezt_az
#ob_mot_#ez_z#o_tum_jek_ezt_obj_ktu_umo_ekt_az#_t#a_ot#_bje_zt#_#az	ezt_az_objektumot
#ob_mot_z#o_tum_jek_obj_ktu_umo_ekt_az#_ot#_#va_bje_vag_gy#_#az_t#v_agy	az_objektumot_vagy
ktu_vag_nin_mot_tum_ncs_y#n_agy_#ob_obj_#va_ot#_ekt_gy#_inc_bje_#ni_t#v_jek_umo_cs#	objektumot_vagy_nincs
#en_ged_nin_#va_vag_inc_gy#_nge_#ni_ed#_s#e_eng_ncs_cs#_y#n_agy	vagy_nincs_enged
zve_ezv_#en_ged_d#l_yez_nge_inc_lye_#ni_ve#_ed#_#ly_s#e_eng_ncs_cs#_nin	nincs_enged_lyezve
zve_ezv_#en_ged_d#l_yez_nge_e#a_lye_ve#_#a#_ed#_#ly_eng	enged_lyezve_a
zve_ezv_has_asz_szn_zn#_yez_#ha_e#a_lye_ve#_#a#_#ly_a#h	lyezve_a_haszn
has_#la_asz_lat_szn_zn#_#ha_ata_#a#_n#l_a#h_ta#	a_haszn_lata
has_#la_Int_asz_lat_ern_zn#_szn_a#I_ter_#ha_net_ata_nte_et#_n#l_rne_#In_ta#	haszn_lata_Internet
ern_#Ex_lat_net_rbe_rne_#In_Exp_Int_erb_ore_et#_lor_ben_a#I_ata_nte_ta#_#la_t#E_xpl_rer_ter_plo_en#	lata_Internet_Explorerben
ern_#Ex_net_rbe_rne_#In_Exp_Int_el#_erb_n#e_ore_#el_et#_lor_ben_nte_t#E_xpl_rer_ter_plo_en#	Internet_Explorerben_el
#Ex_rbe_ulh_Exp_ord_el#_erb_n#e_ore_#el_at#_lor_#fo_ben_rdu_lha_xpl_rer_for_plo_l#f_hat_dul_en#	Explorerben_el_fordulhat
ord_rdu_#fo_lha_el#_for_hog_at#_ogy_gy#_#ho_#el_t#h_l#f_hat_dul_ulh	el_fordulhat_hogy
ord_rdu_#fo_lha_#az_for_ogy_at#_gy#_#ho_az#_t#h_hog_hat_dul_y#a_ulh	fordulhat_hogy_az
Act_ogy_tiv_cti_gy#_az#_#Ac_veX_ive_hog_#az_eX#_y#a_#ho_z#A	hogy_az_ActiveX
X#k_ns#_Act_kom_omp_tiv_cti_az#_#Ac_#ko_mpo_pon_nen_veX_ive_eX#_#az_ens_one_z#A	az_ActiveX_komponens
X#k_ns#_Act_kom_omp_#ki_tiv_cti_#ko_#Ac_mpo_pon_nen_s#k_veX_ive_eX#_ki#_ens_one	ActiveX_komponens_ki
ns#_kom_omp_#ki_i#v_#va_nen_#ko_mpo_pon_s#k_ki#_an#_van_ens_one	komponens_ki_van
olv_va#_lva_sol_i#v_#ki_cso_#va_#ka_ki#_apc_an#_n#k_kap_pcs_van	ki_van_kapcsolva
olv_va#_lva_sol_cso_#va_#ka_gy#_apc_a#g_an#_n#k_kap_pcs_van_#gy	van_kapcsolva_gy
olv_va#_sol_cso_#ka_gy#_a#g_#ne_em#_pcs_kap_lva_nem_apc_y#n_#gy	kapcsolva_gy_nem
dod_m#t_udo_#tu_od#_tud_gy#_em#_#ne_nem_y#n_#gy	gy_nem_tudod
dod_d#m_m#t_udo_#tu_#m#_od#_tud_em#_#ne_nem	nem_tudod_m
dod_d#m_udo_#tu_#m#_od#_os#_dos_tud_#do_m#d	tudod_m_dos
tan_#m#_ni#_os#_ani_dos_#do_#ta_s#t_m#d	m_dos_tani
tan_i#a_ni#_os#_ani_dos_#a#_#do_#ta_s#t	dos_tani_a
a#k_tan_#k#_i#a_ni#_ani_#a#_#ta	tani_a_k
a#k_ann_#k#_nno_pan_ot#_#pa_#a#_k#p_not	a_k_pannot
ann_#k#_nno_pan_ot#_#pa_ci#_#ci_t#c_k#p_not	k_pannot_ci
ann_#t#_nno_pan_ot#_#pa_ci#_t#c_#ci_i#t_not	pannot_ci_t
Eln_t#E_#t#_ln#_ci#_#El_#ci_i#t	ci_t_Eln
Eln_t#E_#t#_ln#_#z#_#El_n#z	t_Eln_z
Eln_#st_n#z_ln#_#El_#z#_st#_z#s	Eln_z_st
#st_t#a_#a#_#z#_st#_z#s	z_st_a
met_a#k_etl_#ke_lem_eme_ns#_tle_lle_t#a_#a#_kel_len_#st_ens_st#_ell	st_a_kellemetlens
met_a#k_etl_#ke_lem_eme_ns#_tle_s#g_lle_#a#_kel_len_#g#_ens_ell	a_kellemetlens_g
met_etl_#ke_lem_eme_ns#_tle_s#g_g#r_lle_#rt_kel_rt#_len_#g#_ens_ell	kellemetlens_g_rt
g#r_kip_#rt_t#W_rt#_#Wi_ip#_iki_#g#_Wik	g_rt_Wikip
p#d_#di_kip_#rt_t#W_rt#_#Wi_ip#_ia#_iki_dia_Wik	rt_Wikip_dia
#K#_p#d_#di_kip_#Wi_ip#_ia#_a#K_iki_dia_Wik	Wikip_dia_K
pje_zet_a#K_#di_jeg_egy_#pj_yze_gyz_K#p_et#_ia#_#K#_dia	dia_K_pjegyzet
pje_zet_jeg_egy_#pj_gyz_K#p_et#_t#K_#K#_yze	K_pjegyzet_K
pje_zet_jeg_egy_#pj_gyz_K#p_et#_t#K_#K#_yze	pjegyzet_K_pjegyzet
pje_zet_hoz_jeg_egy_#pj_zz#_gyz_t#h_K#p_et#_ozz_#K#_yze_#ho	K_pjegyzet_hozz
pje_zet_hoz_jeg_egy_#pj_zz#_ad#_gyz_t#h_ozz_et#_z#a_yze_#ho_#ad	pjegyzet_hozz_ad
sa#_hoz_zz#_ad#_d#s_z#a_#sa_ozz_#ho_#ad	hozz_ad_sa
sa#_a#W_kip_ad#_d#s_#Wi_ip#_#sa_iki_#ad_Wik	ad_sa_Wikip
sa#_a#W_p#d_#di_kip_ia#_#Wi_ip#_#sa_iki_dia_Wik	sa_Wikip_dia
#K#_p#d_#di_kip_#Wi_ip#_ia#_a#K_iki_dia_Wik	Wikip_dia_K
pje_zet_a#K_#di_jeg_egy_#pj_yze_gyz_K#p_et#_ia#_#K#_dia	dia_K_pjegyzet
pje_zet_jeg_egy_#pj_gyz_K#p_et#_t#K_#K#_yze	K_pjegyzet_K
pje_zet_jeg_egy_#pj_gyz_K#p_et#_t#K_#K#_yze	pjegyzet_K_pjegyzet
pje_zet_t#m_#m#_jeg_egy_#pj_gyz_K#p_et#_#K#_yze	K_pjegyzet_m
pje_zet_#m#_jeg_egy_dos_#pj_os#_gyz_#do_et#_t#m_yze_m#d	pjegyzet_m_dos
#m#_#t#_os#_dos_#do_s#t_m#d	m_dos_t
sa#_#t#_os#_dos_t#s_#do_#sa_s#t	dos_t_sa
sa#_a#W_#t#_kip_t#s_#Wi_ip#_#sa_iki_Wik	t_sa_Wikip
sa#_a#W_p#d_#di_kip_ia#_#Wi_ip#_#sa_iki_dia_Wik	sa_Wikip_dia
#K#_p#d_#di_kip_#Wi_ip#_ia#_a#K_iki_dia_Wik	Wikip_dia_K
pje_zet_a#K_#di_jeg_egy_#pj_yze_gyz_K#p_et#_ia#_#K#_dia	dia_K_pjegyzet
pje_zet_jeg_egy_#pj_gyz_K#p_et#_t#K_#K#_yze	K_pjegyzet_K
pje_zet_jeg_egy_#pj_gyz_K#p_et#_t#K_#K#_yze	pjegyzet_K_pjegyzet
pje_zet_#t#_jeg_egy_#pj_gyz_K#p_et#_#K#_yze_t#t	K_pjegyzet_t
pje_zet_#t#_jeg_egy_#pj_t#r_gyz_#rl_et#_yze_t#t_rl#	pjegyzet_t_rl
#se_#t#_l#s_t#r_#rl_se#_rl#	t_rl_se
#se_l#s_#rl_se#_rl#	rl_se
#se_se#	se
