cues	outcomes
WAGNER	RESCORLA
MODELL_RESCORLA	WAGNER
WAGNER_BEVEZET_RESCORLA	MODELL
MODELL_WAGNER_SZERKESZT	BEVEZET
MODELL_SE_BEVEZET	SZERKESZT
SZERKESZT_BEVEZET_A	SE
SZERKESZT_SE_Wikip	A
di_SE_A	Wikip
Wikip_b_A	di
di_l_Wikip	b
di_a_b	l
l_szabad_b	a
l_enciklop_a	szabad
szabad_di_a	enciklop
szabad_enciklop_b	di
di_enciklop_l	b
di_b_Ugr	l
l_b_s	Ugr
l_navig_Ugr	s
s_ci_Ugr	navig
s_navig_keres	ci
s_navig_ci	keres
ci_A_keres	s
s_RESCORLA_keres	A
s_WAGNER_A	RESCORLA
RESCORLA_A_MODELL	WAGNER
WAGNER_a_RESCORLA	MODELL
MODELL_WAGNER_klasszikus	a
MODELL_kondicion_a	klasszikus
l_a_klasszikus	kondicion
s_kondicion_klasszikus	l
l_kondicion_egy	s
l_modellje_s	egy
s_egy_amelyben	modellje
egy_az_modellje	amelyben
llatot_amelyben_modellje	az
arra_amelyben_az	llatot
tan_llatot_az	arra
arra_llatot_tj	tan
k_arra_tan	tj
tj_tan_hogy	k
tj_k	hogy
l_k_hogy	k
k_hogy_nbs	l
l_k_get	nbs
l_nbs_tudjon	get
tenni_nbs_get	tudjon
ak_get_tudjon	tenni
tenni_z_tudjon	ak
tenni_ak_tt	z
ak_ami_z	tt
v_tt_z	ami
rhat_tt_ami	v
an_v_ami	rhat
rhat_t_v	an
rhat_an_rt	t
nni_an_t	rt
t_rt_fog	nni
nni_rt_s	fog
nni_ami_fog	s
s_val_fog	ami
s_j_ami	val
val_ban_ami	j
val_t_j	ban
j_ban_rt	t
ban_nik_t	rt
t_rt_Ez	nik
egy_rt_nik	Ez
k_nik_Ez	egy
s_egy_Ez	k
k_egy_rleti	s
s_k_modell	rleti
s_rleti_amelyben	modell
rleti_minden_modell	amelyben
egyes_amelyben_modell	minden
inger_minden_amelyben	egyes
vagy_egyes_minden	inger
inger_egyes_jelen	vagy
inger_van_vagy	jelen
vagy_jelen	van
jelen_van_nincs	vagy
vagy_jelen_van	nincs
vagy_egy_nincs	jelen
jelen_meghat_nincs	egy
rozott_jelen_egy	meghat
pillanatban_egy_meghat	rozott
a_rozott_meghat	pillanatban
pillanatban_pr_rozott	a
pillanatban_a_b	pr
pr_a_ban	b
pr_b_Az	ban
el_ban_b	Az
ban_Az_rejelz	el
el_se_Az	rejelz
el_a_rejelz	se
se_rejelz_felt	a
se_a_tlen	felt
ingernek_a_felt	tlen
a_tlen_felt	ingernek
ingernek_k_tlen	a
ingernek_a_s	k
rletben_k_a	s
s_k_bemutathat	rletben
s_mint_rletben	bemutathat
rletben_bemutathat_az	mint
mint_bemutathat_asszociat	az
v_mint_az	asszociat
az_er_asszociat	v
v_ss_asszociat	er
g_v_er	ss
ss_sszess_er	g
g_ss_ge	sszess
g_a_sszess	ge
ge_k_sszess	a
s_ge_a	k
rletben_k_a	s
s_jelenlev_k	rletben
s_kondicion_rletben	jelenlev
rletben_jelenlev_lt	kondicion
kondicion_jelenlev_ingereknek	lt
kondicion_Ez_lt	ingereknek
ingereknek_a_lt	Ez
ingereknek_Ez_jellegzetess	a
ge_a_Ez	jellegzetess
a_jellegzetess	ge
ge_modellnek_jellegzetess	a
ge_bemutatja_a	modellnek
modellnek_a	bemutatja
bemutatja_modellnek_nagy	a
jelent_bemutatja_a	nagy
s_a_nagy	jelent
jelent_g_nagy	s
s_jelent_el	g
s_g_rehalad	el
el_g_st	rehalad
el_rehalad_a	st
kor_rehalad_st	a
bbi_st_a	kor
modellekhez_kor_a	bbi
viszony_kor_bbi	modellekhez
modellekhez_bbi_tva	viszony
modellekhez_s_viszony	tva
viszony_lehet_tva	s
s_v_tva	lehet
s_lehet_tette	v
lehet_v_a	tette
fontos_v_tette	a
k_a_tette	fontos
fontos_a_s	k
fontos_rleti_k	s
s_k_jelens	rleti
s_rleti_gek	jelens
egyszer_rleti_jelens	gek
magyar_jelens_gek	egyszer
egyszer_zat_gek	magyar
egyszer_magyar_t	zat
mint_magyar_zat	t
t_a_zat	mint
t_blokkol_mint	a
s_mint_a	blokkol
blokkol_a_Ebb	s
s_l_blokkol	Ebb
s_Ebb_kifoly	l
l_Ebb_lag	kifoly
l_a_kifoly	lag
lag_kifoly_Rescorla	a
Wagner_lag_a	Rescorla
Rescorla_a_modell	Wagner
Wagner_lett_Rescorla	modell
Wagner_az_modell	lett
lett_egyik_modell	az
lett_legbefoly_az	egyik
egyik_az_sosabb	legbefoly
egyik_legbefoly_modell	sosabb
legbefoly_a_sosabb	modell
tanul_modell_sosabb	a
sn_a_modell	tanul
l_tanul_a	sn
tanul_sn_hab	l
l_r_sn	hab
l_gyakran_hab	r
r_b_hab	gyakran
r_gyakran	b
gyakran_b_lt	r
r_k_b	lt
r_lt_megjelen	k
se_k_lt	megjelen
k_ta_megjelen	se
se_A_megjelen	ta
se_Rescorla_ta	A
Wagner_ta_A	Rescorla
Rescorla_modell_A	Wagner
Wagner_Rescorla_a	modell
Wagner_modell_figyelem	a
k_a_modell	figyelem
z_a_figyelem	k
k_ppontj_figyelem	z
ba_k_z	ppontj
ker_ppontj_z	ba
ba_ppontj_lt	ker
ba_ker_az	lt
elm_ker_lt	az
az_lt	elm
elm_az_vekben	lt
elm_hiszen_lt	vekben
lt_sz_vekben	hiszen
mos_hiszen_vekben	sz
tanulm_hiszen_sz	mos
mos_sz_ny	tanulm
utalt_tanulm_mos	ny
tanulm_arra_ny	utalt
utalt_hogy_ny	arra
utalt_arra_a	hogy
arra_f_hogy	a
a_hogy_zisos	f
f_a_tev	zisos
f_kenys_zisos	tev
ge_tev_zisos	kenys
tev_a_kenys	ge
dopamin_ge_kenys	a
ge_a_neuronoknak	dopamin
dopamin_a	neuronoknak
dopamin_mesostriatal_neuronoknak	a
a_DA_neuronoknak	mesostriatal
el_mesostriatal_a	DA
mesostriatal_DA_rejelz	el
el_DA_sekben	rejelz
el_a_rejelz	sekben
k_sekben_rejelz	a
a_sekben_z	k
pagyban_k_a	z
k_z	pagyban
pagyban_dolja_z	k
pagyban_k_a	dolja
k_dolja_hiba	a
r_a_dolja	hiba
a_hiba_szleteit	r
r_a_hiba	szleteit
r_modellben_szleteit	a
a_A_szleteit	modellben
modellben_Rescorla_a	A
Wagner_modellben_A	Rescorla
modellj_Rescorla_A	Wagner
Wagner_t_Rescorla	modellj
Wagner_modellj_Robert	t
t_modellj_A	Robert
t_Robert_Rescorla	A
hozta_Robert_A	Rescorla
l_Rescorla_A	hozta
hozta_Rescorla_tre	l
l_hozta_Pennsylvania	tre
l_Egyetemr_tre	Pennsylvania
l_Pennsylvania_tre	Egyetemr
s_Egyetemr_Pennsylvania	l
l_Allan_Egyetemr	s
l_R_s	Allan
s_Allan_Wagner	R
Yale_Allan_R	Wagner
Wagner_Egyetemr_R	Yale
Wagner_Yale_l	Egyetemr
Yale_Tartalomjegyz_Egyetemr	l
l_k_Egyetemr	Tartalomjegyz
l_Tartalomjegyz_elrejt	k
s_k_Tartalomjegyz	elrejt
Siker_k_elrejt	s
s_elrejt	Siker
s_Siker_a	s
s_Siker_n	a
s_pszer_a	n
s_n_a	pszer
pszer_g_n	s
s_pszer_A	g
s_g_modell	A
alapvet_g_A	modell
modell_A_felt	alapvet
alapvet_modell_telez	felt
alapvet_sei_felt	telez
Egyenlet_telez_felt	sei
A_telez_sei	Egyenlet
Egyenlet_fel_sei	A
Egyenlet_lvizsg_A	fel
lt_A_fel	lvizsg
Rescorla_lvizsg_fel	lt
Wagner_lt_lvizsg	Rescorla
Rescorla_lt_modell	Wagner
Wagner_Rescorla_Van	modell
Wagner_Hamme_modell	Van
t_Van_modell	Hamme
l_Van_Hamme	t
s_t_Hamme	l
l_t_Wasserman	s
l_t_s	Wasserman
s_l_Wasserman	t
t_Wasserman_N	l
l_t_h	N
l_N_ny	h
N_h_hiba	ny
a_h_ny	hiba
Rescorla_ny_hiba	a
Wagner_a_hiba	Rescorla
modellben_Rescorla_a	Wagner
Wagner_Rescorla_A	modellben
Wagner_modellben_kor	A
modellben_A_bban	kor
kor_kondicion_A	bban
kor_lt_bban	kondicion
kondicion_g_bban	lt
kondicion_lt_tl	g
g_megsz_lt	tl
g_n_tl	megsz
se_megsz_tl	n
megsz_n_jrapozicion	se
se_l_n	jrapozicion
se_jrapozicion_s	l
l_a_jrapozicion	s
l_kihal_s	a
s_a	kihal
ut_a_kihal	s
s_n_kihal	ut
s_ut_A	n
ut_serkent_n	A
s_n_A	serkent
s_serkent_A	s
s_a_serkent	s
s_g	a
s_a_tl	g
s_g_a	tl
kiz_g_tl	s
s_r_tl	kiz
s_lagoss_kiz	r
kiz_r_ga	lagoss
j_r_lagoss	ga
inger_ga_lagoss	j
j_p_ga	inger
j_inger_ros	p
inger_t_p	ros
sa_ros_p	t
t_ros_a	sa
t_sa_kondicion	a
sa_a_lt	kondicion
kondicion_g_a	lt
kondicion_lt_tl	g
val_g_lt	tl
g_tl_CS	val
val_preexposure_tl	CS
val_CS_hat	preexposure
CS_preexposure_sa	hat
hat_l_preexposure	sa
hat_tens_sa	l
l_g_sa	tens
l_tens_tl	g
s_tens_g	tl
g_tl_Magasabb	s
s_rend_tl	Magasabb
s_kondicion_Magasabb	rend
l_rend_Magasabb	kondicion
s_kondicion_rend	l
l_kondicion_rz	s
l_kszervi_s	rz
s_rz_el	kszervi
kondicion_kszervi_rz	el
el_l_kszervi	kondicion
el_kondicion_s	l
l_kondicion_Hivatkoz	s
l_sok_s	Hivatkoz
s_Hivatkoz_K	sok
Hivatkoz_ls_sok	K
K_sok_hivatkoz	ls
K_ls_sok	hivatkoz
ls_Forr_hivatkoz	sok
sok_hivatkoz	Forr
Siker_sok_Forr	sok
s_sok_Forr	Siker
Siker_a_sok	s
s_Siker_n	a
s_pszer_a	n
s_n_a	pszer
pszer_g_n	s
s_pszer_szerkeszt	g
s_g	szerkeszt
szerkeszt_g_A	s
s_szerkeszt_RESCORLA	A
s_WAGNER_A	RESCORLA
RESCORLA_A_MODELL	WAGNER
SIKERESS_WAGNER_RESCORLA	MODELL
MODELL_WAGNER_G	SIKERESS
MODELL_SIKERESS_NEK	G
SIKERESS_S_G	NEK
NEK_N_G	S
PSZER_S_NEK	N
S_N	PSZER
PSZER_N_G	S
PSZER_NEK_S	G
OKAI_S_G	NEK
NEK_G_tud	OKAI
OKAI_gener_NEK	tud
lni_OKAI_tud	gener
gener_tud_vil	lni
gos_lni_gener	vil
s_lni_vil	gos
gos_vil_ordin	s
s_lis_gos	ordin
s_j_ordin	lis
lis_ordin_slatokat	j
j_t_lis	slatokat
j_bb_slatokat	t
t_sikeres_slatokat	bb
j_t_bb	sikeres
sikeres_slata_bb	j
j_van_sikeres	slata
j_slata_feldolgoz	van
s_van_slata	feldolgoz
van_feldolgoz_eset	s
s_n_feldolgoz	eset
s_az_eset	n
n_intenzit_eset	az
snak_n_az	intenzit
s_az_intenzit	snak
snak_v_intenzit	s
snak_ratlans_s	v
s_v_gnak	ratlans
ratlans_intuit_v	gnak
ratlans_v_gnak	intuit
hat_intuit_gnak	v
intuit_v_sa	hat
hat_v_van	sa
hat_jelent_sa	van
s_van_sa	jelent
heurisztikus_jelent_van	s
s_jelent_rt	heurisztikus
s_ket_heurisztikus	rt
heurisztikus_rt_ny	ket
rt_ket_jt	ny
viszonylag_ket_ny	jt
kev_jt_ny	viszonylag
viszonylag_jt_s	kev
viszonylag_kev_szabad	s
s_kev_param	szabad
s_szabad_ter	param
szabad_param_s	ter
param_ter_f	s
s_ter_ggetlen	f
s_v_f	ggetlen
ggetlen_f_ltoz	v
ggetlen_v_kat	ltoz
ltoz_tartalmaz_v	kat
ltoz_kev_kat	tartalmaz
s_tartalmaz_kat	kev
tartalmaz_kev_konkurenci	s
s_kev_ja	konkurenci
s_volt_konkurenci	ja
ja_m_konkurenci	volt
s_ja_volt	m
elm_volt_m	s
s_letekt_m	elm
s_l_elm	letekt
elm_A_letekt	l
l_letekt_modell	A
l_alapvet_A	modell
modell_A_felt	alapvet
alapvet_modell_telez	felt
alapvet_sei_felt	telez
szerkeszt_telez_felt	sei
s_telez_sei	szerkeszt
szerkeszt_A_sei	s
s_szerkeszt_meglepet	A
s_A	meglepet
meglepet_A_nagys	s
s_meglepet_ga	nagys
s_amit_nagys	ga
a_ga_nagys	amit
amit_szervezet_ga	a
tapasztal_amit_a	szervezet
amikor_a_szervezet	tapasztal
tapasztal_tal_szervezet	amikor
tapasztal_amikor_lkozik	tal
amikor_tal_egy	lkozik
lkozik_tal_felt	egy
lkozik_egy_tlen	felt
ingerrel_egy_felt	tlen
US_tlen_felt	ingerrel
ingerrel_feltehet_tlen	US
ingerrel_en_US	feltehet
US_f_feltehet	en
en_gg_feltehet	f
en_f_a	gg
k_f_gg	a
s_gg_a	k
rlet_k_a	s
s_sor_k	rlet
s_rlet_n	sor
rlet_sor_jelenlev	n
sor_n_jelek	jelenlev
jelenlev_n_sszes	jelek
jelenlev_jelek_tett	sszes
sszes_jelek_asszociat	tett
v_sszes_tett	asszociat
rt_tett_asszociat	v
v_k_asszociat	rt
t_v_rt	k
l_k_rt	t
t_k_Ez	l
l_t_a	Ez
l_Ez_felt	a
a_Ez_telez	felt
s_a_felt	telez
elt_telez_felt	s
s_r_telez	elt
s_elt_a	r
r_elt_kor	a
r_a_bbi	kor
kor_modellekt_a	bbi
l_kor_bbi	modellekt
bbi_modellekt_amelyek	l
l_modellekt_a	amelyek
l_kondicion_amelyek	a
amelyek_a_lt	kondicion
kondicion_a_felt	lt
teles_kondicion_lt	felt
ingernek_lt_felt	teles
teles_CS_felt	ingernek
teles_csak_ingernek	CS
ingernek_CS_az	csak
csak_CS_asszociat	az
csak_v_az	asszociat
rt_az_asszociat	v
v_k_asszociat	rt
t_v_rt	k
vett_k_rt	t
t_k	vett
vett_t_figyelembe	k
vett_Serkent_k	figyelembe
s_figyelembe_k	Serkent
s_Serkent_figyelembe	s
s_Serkent_a	s
s_g	a
s_a_tl	g
s_g_a	tl
ellent_g_tl	s
s_tes_tl	ellent
s_ellent_funkci	tes
ellent_k_tes	funkci
funkci_Egy_tes	k
ingernek_funkci_k	Egy
csak_k_Egy	ingernek
ingernek_Egy_pozit	csak
ingernek_v_csak	pozit
csak_asszoci_pozit	v
v_ci_pozit	asszoci
s_v_asszoci	ci
asszoci_ci_ereje	s
s_l_ci	ereje
s_v_ereje	l
l_n_ereje	v
l_kondicion_v	n
v_n_lt	kondicion
kondicion_n_serkent	lt
vagy_kondicion_lt	serkent
negat_serkent_lt	vagy
vagy_v_serkent	negat
vagy_negat_asszociat	v
v_negat	asszociat
v_ereje_asszociat	v
l_v_asszociat	ereje
v_ereje	l
l_n_ereje	v
l_kondicion_v	n
v_n_lt	kondicion
kondicion_g_n	lt
kondicion_lt_tl	g
lehet_g_lt	tl
nem_g_tl	lehet
lehet_tl	nem
nem_lehet_mindkett	lehet
nem_lehet_Az	mindkett
inger_lehet_mindkett	Az
mindkett_Az_asszociat	inger
inger_v_Az	asszociat
inger_ereje_asszociat	v
v_k_asszociat	ereje
v_zvetlen_ereje	k
l_k_ereje	zvetlen
zvetlen_k_a	l
l_zvetlen_viselked	a
l_a_sben	viselked
van_a_viselked	sben
kifejezve_viselked_sben	van
van_sben_amit	kifejezve
kiv_van_kifejezve	amit
kifejezve_lt_amit	kiv
kiv_amit_g	lt
kiv_tol_lt	g
g_Nincs_lt	tol
g_tol_m	Nincs
d_Nincs_tol	m
megismerni_Nincs_m	d
az_d_m	megismerni
megismerni_ingert_d	az
megismerni_an_az	ingert
lk_ingert_az	an
l_an_ingert	lk
an_lk_hogy	l
l_megmutatn_lk	hogy
l_hogy_nk	megmutatn
a_megmutatn_hogy	nk
nk_megmutatn_szervezet	a
nk_a_reakci	szervezet
a_szervezet_it	reakci
A_szervezet_reakci	it
CS_reakci_it	A
f_it_A	CS
r_CS_A	f
CS_f_sze	r
r_f_lland	sze
r_A_sze	lland
CS_lland_sze	A
lland_alpha_A	CS
CS_f_A	alpha
r_CS_alpha	f
f_alpha_sze	r
nem_r_f	sze
szabad_r_sze	nem
nem_hogy_sze	szabad
nem_szabad_v	hogy
szabad_hogy_ltozzon	v
a_v_hogy	ltozzon
v_k_ltozzon	a
s_a_ltozzon	k
rlet_k_a	s
s_sor_k	rlet
s_rlet_n	sor
gy_rlet_sor	n
k_sor_n	gy
gy_n_pviselhet	k
gy_k_az	pviselhet
k_lland_pviselhet	az
val_az_pviselhet	lland
lland_az_A	val
val_jelek_lland	A
val_folyamata_A	jelek
jelek_nincs_A	folyamata
hat_jelek_folyamata	nincs
ssal_folyamata_nincs	hat
hat_a_nincs	ssal
hat_ssal_jelenlegi	a
ssal_a_llapotra	jelenlegi
jelenlegi_a_Ez	llapotra
csak_jelenlegi_llapotra	Ez
a_Ez_llapotra	csak
csak_jelek_Ez	a
csak_a_aktu	jelek
lis_jelek_a	aktu
jelek_aktu_asszociat	lis
v_lis_aktu	asszociat
lis_rt_asszociat	v
v_ke_asszociat	rt
amely_v_rt	ke
rt_meghat_ke	amely
rozza_amely_ke	meghat
amely_meghat_a	rozza
rozza_tanul_meghat	a
rozza_a_s	tanul
mennyis_tanul_a	s
s_g_tanul	mennyis
s_t_mennyis	g
mennyis_Nem_g	t
t_g_sz	Nem
t_Nem_m	sz
t_Nem_sz	m
hogy_m_sz	t
t_a_m	hogy
t_CS_hogy	a
a_hogy_t	CS
t_CS_a	t
bbsz_t_CS	t
t_r	bbsz
bbsz_t_is	r
bbsz_r_pr	is
is_r_b	pr
is_pr_lt	b
pr_k_b	lt
meghat_b_lt	k
k_lt_rozni	meghat
vagy_k_meghat	rozni
hasonl_meghat_rozni	vagy
vagy_Az_rozni	hasonl
vagy_hasonl_els	Az
hasonl_k_Az	els
t_Az_els	k
k_els_felt	t
t_k_telez	felt
s_t_felt	telez
egyed_telez_felt	s
s_l_telez	egyed
s_egyed_ll	l
l_an_egyed	ll
l_a_ll	an
an_Rescorla_ll	a
Wagner_an_a	Rescorla
Rescorla_a_modell	Wagner
Wagner_Rescorla_jellemz	modell
Wagner_modell_je	jellemz
jellemz_modell_Az	je
utols_jellemz_je	Az
Az_h_je	utols
utols_Az_rom	h
utols_h_felt	rom
rom_h_telez	felt
rom_s_felt	telez
jelen_telez_felt	s
s_volt_telez	jelen
s_jelen_el	volt
jelen_volt_z	el
el_volt_modellekben	z
el_z_is	modellekben
Nem_z_modellekben	is
is_a_modellekben	Nem
is_Nem_legfontosabb	a
r_Nem_a	legfontosabb
sze_a_legfontosabb	r
r_az_legfontosabb	sze
r_elm_sze	az
letnek_az_sze	elm
de_elm_az	letnek
jelent_elm_letnek	de
s_de_letnek	jelent
jelent_a_de	s
s_jelent_szerepe	a
s_Egyenlet_a	szerepe
szerkeszt_a_szerepe	Egyenlet
s_Egyenlet_szerepe	szerkeszt
szerkeszt_Egyenlet_VXn	s
s_szerkeszt_X	VXn
s_Vtot_VXn	X
X_displaystyle_VXn	Vtot
X_Vtot_Delta	displaystyle
V_displaystyle_Vtot	Delta
X_displaystyle_Delta	V
V_n_Delta	X
X_V_alpha	n
X_n	alpha
n_beta_alpha	X
lambda_X_alpha	beta
X_beta_V	lambda
lambda_tot_beta	V
lambda_V_s	tot
V_tot_VXn	s
s_tot_VXn	VXn
s_VXn	VXn
displaystyle_VXn	VXn
V_VXn	displaystyle
X_displaystyle_VXn	V
V_n_displaystyle	X
X_V	n
X_n	V
V_n	X
X_V_Delta	n
X_n_V	Delta
X_n_Delta	V
V_n_Delta	X
X_ahol_V	n
X_n_V	ahol
ahol_X_n	V
ahol_V_a	X
X_V_v	a
ltoz_X_a	v
v_a_az	ltoz
ltoz_v_X	az
ltoz_asszoci_az	X
ci_X_az	asszoci
X_asszoci_er	ci
ss_asszoci_ci	er
g_ci_er	ss
ben_ss_er	g
g_ss_a	ben
g_ben_kiugr	a
s_ben_a	kiugr
a_kiugr	s
s_kiugr_felt	a
s_teles_a	felt
inger_a_felt	teles
teles_hat_felt	inger
teles_inger_rolt	hat
inger_hat_s	rolt
hat_az_rolt	s
s_US_rolt	az
s_ar_az	US
US_az_ny	ar
param_US_ar	ny
tere_ar_ny	param
hat_param_ny	tere
param_tere_rolt	hat
hat_tere_s	rolt
hat_m_rolt	s
s_rolt	m
s_n_m	s
s_ven_m	n
s_n_az	ven
asszoci_n_ven	az
ci_az_ven	asszoci
rt_asszoci_az	ci
asszoci_ci_ke	rt
az_rt_ci	ke
rt_ke_US	az
lehets_az_ke	US
US_az_ges	lehets
lehets_US_maximum	ges
lehets_kondicion_ges	maximum
l_ges_maximum	kondicion
kondicion_ja_maximum	l
l_kondicion_V	ja
l_ja_X	V
ja_a_V	X
X_V_jelenlegi	a
X_a_asszociat	jelenlegi
v_jelenlegi_a	asszociat
jelenlegi_er_asszociat	v
v_V_asszociat	er
t_v_er	V
V_o_er	t
t_V	o
t_a_o	t
t_o_teljes	a
t_a_asszociat	teljes
v_a_teljes	asszociat
teljes_ereje_asszociat	v
v_az_asszociat	ereje
v_ereje_sszes	az
a_az_ereje	sszes
sszes_az_felt	a
teles_sszes_a	felt
ingernek_a_felt	teles
teles_A_felt	ingernek
teles_fel_ingernek	A
ingernek_lvizsg_A	fel
lt_A_fel	lvizsg
Rescorla_lvizsg_fel	lt
Wagner_lt_lvizsg	Rescorla
Rescorla_lt_modell	Wagner
Wagner_Rescorla_Van	modell
Wagner_Hamme_modell	Van
t_Van_modell	Hamme
l_Van_Hamme	t
s_t_Hamme	l
l_t_Wasserman	s
l_t_s	Wasserman
s_l_Wasserman	t
szerkeszt_t_Wasserman	l
l_t_s	szerkeszt
l_szerkeszt_Van	s
s_szerkeszt_Hamme	Van
s_Van	Hamme
Wasserman_Van_Hamme	s
s_Hamme_kiterjesztette	Wasserman
s_Wasserman_az	kiterjesztette
Wasserman_kiterjesztette_eredeti	az
az_Rescorla_kiterjesztette	eredeti
Wagner_az_eredeti	Rescorla
Rescorla_RW_eredeti	Wagner
Wagner_modellt_Rescorla	RW
Wagner_RW_s	modellt
j_modellt_RW	s
s_t_modellt	j
s_nyez_j	t
j_t	nyez
nyez_t_mutatott	t
nyez_t_be	mutatott
t_mutatott_az	be
be_j_mutatott	az
be_az_RW	j
j_modellben_az	RW
j_ben_RW	modellben
modellben_Azt_RW	ben
modellben_ben_javasolt	Azt
k_Azt_ben	javasolt
Azt_hogy_javasolt	k
nem_k_javasolt	hogy
csak_k_hogy	nem
nem_a_hogy	csak
nem_kondicion_csak	a
csak_a_lt	kondicion
kondicion_a_ingerek	lt
kondicion_lt_melyek	ingerek
fizikailag_lt_ingerek	melyek
melyek_jelen_ingerek	fizikailag
melyek_fizikailag_vannak	jelen
fizikailag_az_jelen	vannak
jelen_k_vannak	az
s_az_vannak	k
rletben_k_az	s
s_v_k	rletben
s_ltozhatnak_rletben	v
rletben_v_asszociat	ltozhatnak
ltozhatnak_v	asszociat
ltozhatnak_er_asszociat	v
v_ss_asszociat	er
g_v_er	ss
ss_kben_er	g
g_ss_hanem	kben
az_g_kben	hanem
hanem_kben_asszociat	az
v_hanem_az	asszociat
rt_az_asszociat	v
v_ke_asszociat	rt
is_v_rt	ke
v_rt_ke	is
is_ltoztathat_ke	v
is_v_a	ltoztathat
ltoztathat_v_felt	a
teles_ltoztathat_a	felt
ingernek_a_felt	teles
teles_egy_felt	ingernek
teles_bels_ingernek	egy
ingernek_egy_sszetett	bels
bels_egy_t	sszetett
rs_bels_sszetett	t
t_sszetett	rs
rs_t_s	t
rs_t_val	s
s_t_Bel	val
s_l_val	Bel
val_sszetett_Bel	l
l_Bel_sz	sszetett
l_sszetett_vets	sz
g_sszetett_sz	vets
j_sz_vets	g
g_n_vets	j
j_l_g	n
j_n_tre	l
l_n_ha	tre
l_k_tre	ha
t_ha_tre	k
k_ha_CSt	t
t_k_egy	CSt
t_tt_CSt	egy
egy_CSt_mutatnak	tt
be_egy_tt	mutatnak
a_tt_mutatnak	be
be_k_mutatnak	a
be_pz_a	k
s_k_a	pz
pz_sor_k	s
s_pz_n	sor
s_sor_sszetett	n
inger_sor_n	sszetett
n_sszetett_Ha	inger
inger_sszetett_az	Ha
inger_egyik_Ha	az
az_Ha_komponens	egyik
egyik_az_felt	komponens
teles_egyik_komponens	felt
inger_komponens_felt	teles
teles_egyed_felt	inger
teles_l_inger	egyed
inger_egyed_mutatkozik	l
l_akkor_egyed	mutatkozik
l_mutatkozik_azt	akkor
akkor_kell_mutatkozik	azt
akkor_felt_azt	kell
telezni_kell_azt	felt
kell_hogy_felt	telezni
telezni_aktiv_felt	hogy
telezni_hogy_lja	aktiv
a_aktiv_hogy	lja
k_aktiv_lja	a
pviselet_a_lja	k
t_k_a	pviselet
pviselet_k_a	t
pviselet_t	a
t_a_bbi	t
t_a_kor	bbi
t_bban_bbi	kor
bbi_p_kor	bban
kor_ros_bban	p
tott_bban_p	ros
ros_felt_p	tott
teles_tott_ros	felt
inger_tott_felt	teles
teles_is_felt	inger
teles_inger_Van	is
inger_Hamme_is	Van
is_Van_s	Hamme
Wasserman_Van_Hamme	s
s_Hamme_javasolja	Wasserman
s_Wasserman_hogy	javasolja
javasolja_Wasserman_ingerek	hogy
javasolja_k_hogy	ingerek
zvetve_hogy_ingerek	k
k_a_ingerek	zvetve
bels_zvetve_k	a
sszetett_zvetve_a	bels
bels_a_t	sszetett
rs_bels_sszetett	t
t_sszetett	rs
rs_t_s	t
rs_t_val	s
s_t_negat	val
s_v_val	negat
val_negat_tanul	v
v_negat_si	tanul
param_v_tanul	si
tert_tanul_si	param
kapunk_param_si	tert
tert_param_gy	kapunk
tert_kapunk_a	gy
gy_kapunk_jelens	a
gy_a_gek	jelens
visszamen_a_jelens	gek
jelens_leges_gek	visszamen
jra_visszamen_gek	leges
rt_visszamen_leges	jra
kel_leges_jra	rt
s_rt_jra	kel
t_rt_kel	s
s_lehet_kel	t
s_t_magyar	lehet
t_lehet_zni	magyar
lehet_Vegy_magyar	zni
k_magyar_zni	Vegy
a_Vegy_zni	k
Vegy_k	a
vetkez_k_a	k
k_a_p	vetkez
vetkez_k_ld	p
t_vetkez_p	ld
egy_ld_p	t
t_k_ld	egy
s_t_egy	k
k_egy_rleti	s
s_k_paradigm	rleti
s_rleti_t	paradigm
rleti_a_paradigm	t
t_h_paradigm	a
t_a_tra	h
a_h_z	tra
rol_h_tra	z
s_z_tra	rol
rol_z_t	s
s_rol_ami	t
s_t_jelzi	ami
t_ami_a	jelzi
visszamen_ami_jelzi	a
a_jelzi_leges	visszamen
visszamen_a_jra	leges
rt_visszamen_leges	jra
kel_leges_jra	rt
rt_st_jra	kel
ahol_rt_kel	st
AB_st_kel	ahol
ahol_st_az	AB
ahol_AB_sszetett	az
inger_AB_az	sszetett
sszetett_az_A	inger
inger_B_sszetett	A
inger_f_A	B
zis_B_A	f
AB_B_f	zis
zis_f_US	AB
zis_AB_f	US
zis_AB_US	f
US_f_A	zis
zis_f_US	A
zis_K_A	US
s_US_A	K
US_K_rletek	s
s_csoport_K	rletek
s_amely_rletek	csoport
megkapta_csoport_rletek	amely
amely_csoport_az	megkapta
megkapta_amely_s	az
megkapta_f_az	s
s_zis_az	f
s_t_f	zis
zis_f_a	t
zis_k_t	a
s_t_a	k
k_a_rletnek	s
s_k_gyeng	rletnek
s_rletnek_bb	gyeng
kondicion_gyeng_rletnek	bb
gyeng_lt_bb	kondicion
kondicion_v_bb	lt
laszt_kondicion_lt	v
v_lt_mutat	laszt
laszt_v_CR	mutat
laszt_a_mutat	CR
B_CR_mutat	a
mint_CR_a	B
B_a	mint
mint_B_kontroll	a
csoport_mint_a	kontroll
kontroll_amely_a	csoport
kontroll_csoport_csak	amely
amely_csoport_az	csak
csak_amely_f	az
csak_zis_az	f
t_f_az	zis
zis_f_kapta	t
zis_Az_t	kapta
t_kapta_eredeti	Az
kapta_RW_Az	eredeti
Az_eredeti_modellje	RW
nem_RW_eredeti	modellje
tudja_RW_modellje	nem
nem_indokolni_modellje	tudja
nem_ezt_tudja	indokolni
a_tudja_indokolni	ezt
hat_ezt_indokolni	a
ezt_st_a	hat
hat_a_de	st
hat_st_az	de
st_de_tdolgozott	az
az_de_modell	tdolgozott
igen_az_tdolgozott	modell
tdolgozott_A_modell	igen
igen_f_modell	A
zisban_igen_A	f
f_az_A	zisban
zisban_f_szt	az
nz_zisban_az	szt
B_az_szt	nz
nz_k_szt	B
nz_zvetve_B	k
k_B_aktiv	zvetve
l_zvetve_k	aktiv
zvetve_aktiv_dott	l
l_aktiv_az	dott
l_A_dott	az
bels_az_dott	A
sszetett_az_A	bels
bels_A_t	sszetett
rs_bels_sszetett	t
t_sszetett	rs
rs_t_s	t
rs_t_val	s
s_t_De	val
s_ahelyett_val	De
val_De_hogy	ahelyett
De_ahelyett_a	hogy
ahelyett_hogy_pozit	a
a_v_hogy	pozit
tanul_a_pozit	v
v_pozit_si	tanul
param_v_tanul	si
tert_tanul_si	param
param_ltal_si	tert
tert_ban_param	ltal
tert_ltal_az	ban
ban_alfa_ltal	az
ban_amikor_az	alfa
fizikailag_alfa_az	amikor
amikor_alfa_jelen	fizikailag
amikor_van_fizikailag	jelen
fizikailag_a_jelen	van
jelen_van_f	a
van_zisban_a	f
B_f_a	zisban
zisban_f_nek	B
zisban_B_negat	nek
v_B_nek	negat
negat_tanul_nek	v
v_negat_si	tanul
param_v_tanul	si
tanul_tere_si	param
param_van_si	tere
gy_param_tere	van
van_tere_a	gy
gy_van_m	a
gy_a_sodik	m
f_a_m	sodik
zis_m_sodik	f
B_f_sodik	zis
zis_f_asszociat	B
zis_v_B	asszociat
B_ereje_asszociat	v
cs_v_asszociat	ereje
kken_v_ereje	cs
cs_az_ereje	kken
cs_kken_A	az
kken_rt_az	A
ke_az_A	rt
viszont_rt_A	ke
rt_ke_n	viszont
viszont_a_ke	n
n_pozit_viszont	a
v_n_a	pozit
tanul_a_pozit	v
v_pozit_si	tanul
param_v_tanul	si
tanul_tere_si	param
miatt_param_si	tere
gy_param_tere	miatt
tere_a_miatt	gy
gy_fel_miatt	a
gy_j_a	fel
tott_a_fel	j
j_RW_fel	tott
j_tott_modell	RW
tott_magyar_RW	modell
modell_RW_zza	magyar
hogy_magyar_modell	zza
a_magyar_zza	hogy
CR_hogy_zza	a
a_amit_hogy	CR
CR_a	amit
B_amit_CR	a
kiv_amit_a	B
B_a_ltott	kiv
kiv_B_a	ltott
kiv_ltott_visszafel	a
blokkol_a_ltott	visszafel
k_a_visszafel	blokkol
blokkol_pz_visszafel	k
s_blokkol_k	pz
ut_pz_k	s
s_pz_n	ut
s_ut_mi	n
ut_rt_n	mi
n_gyeng_mi	rt
rt_mi_bb	gyeng
mint_rt_gyeng	bb
gyeng_az_bb	mint
AB_mint_bb	az
csak_mint_az	AB
kondicion_AB_az	csak
csak_l_AB	kondicion
csak_kondicion_N	l
l_kondicion_h	N
l_N_ny	h
N_h_hiba	ny
a_h_ny	hiba
Rescorla_ny_hiba	a
Wagner_a_hiba	Rescorla
modellben_Rescorla_a	Wagner
Wagner_szerkeszt_Rescorla	modellben
Wagner_modellben_s	szerkeszt
szerkeszt_modellben_Spont	s
s_szerkeszt_n	Spont
s_Spont_fel	n
n_Spont_p	fel
l_n_fel	p
s_p_fel	l
l_a_p	s
l_kihal_s	a
s_a_sb	kihal
l_a_kihal	sb
sb_amit_kihal	l
sb_l_az	amit
l_amit_eml	az
keztet_amit_az	eml
eml_jb_az	keztet
eml_li_keztet	jb
kezel_jb_keztet	li
li_jb_sek	kezel
kezel_okoztak_li	sek
kezel_sek_J	okoztak
okoztak_l_sek	J
okoztak_megalapozott_J	l
l_szrev_J	megalapozott
l_megalapozott_tel	szrev
hogy_megalapozott_szrev	tel
tel_a_szrev	hogy
time_hogy_tel	a
a_out_hogy	time
time_intervallum_a	out
time_out_befejez	intervallum
s_intervallum_out	befejez
t_intervallum_befejez	s
s_k_befejez	t
s_t_vet	k
t_en_k	vet
k_a_vet	en
en_vet_kihal	a
s_en_a	kihal
r_a_kihal	s
s_szleges_kihal	r
s_r_fel	szleges
r_szleges_p	fel
l_szleges_fel	p
p_st_fel	l
l_eredm_p	st
l_nyez_st	eredm
a_st_eredm	nyez
nyez_eredm_kihal	a
nyez_a_sb	kihal
l_a_kihal	sb
sb_azaz_kihal	l
sb_l_a	azaz
l_kor_azaz	a
a_azaz_bban	kor
kor_megsz_a	bban
kor_nt_bban	megsz
megsz_reakci_bban	nt
vagy_nt_megsz	reakci
v_nt_reakci	vagy
vagy_reakci_lasz	v
vagy_v_visszat	lasz
r_v_lasz	visszat
de_visszat_lasz	r
r_ltal_visszat	de
r_de_ban	ltal
alacsonyabb_ltal_de	ban
ban_szinten_ltal	alacsonyabb
ban_mint_alacsonyabb	szinten
a_szinten_alacsonyabb	mint
szinten_mint_kihal	a
s_mint_a	kihal
k_a_kihal	s
s_pz_kihal	k
s_se_k	pz
el_pz_k	se
se_pz_tt	el
se_Ez_el	tt
el_a_tt	Ez
tt_Ez_jelens	a
g_a_Ez	jelens
arra_a_jelens	g
g_utal_jelens	arra
arra_g_hogy	utal
a_arra_utal	hogy
hogy_US_utal	a
a_hogy_kitetts	US
ge_US_a	kitetts
csak_US_kitetts	ge
ge_a_kitetts	csak
csak_ge_k	a
csak_pz_a	k
k_a_st	pz
l_pz_k	st
pz_a_st	l
l_st_kihal	a
l_a_s	kihal
befejez_a_kihal	s
s_se_kihal	befejez
s_ut_befejez	se
se_n_befejez	ut
se_r_ut	n
szleges_ut_n	r
r_n_fel	szleges
r_szleges_p	fel
l_szleges_fel	p
p_st_fel	l
l_okoz_p	st
l_st_a	okoz
okoz_st_kihal	a
okoz_st_a	kihal
l_a_kihal	st
st_Az_kihal	l
l_st_RW	Az
l_Az_modell	RW
nem_Az_RW	modell
tudja_modell_RW	nem
nem_modell_indokolni	tudja
nem_tudja_ezeket	indokolni
a_tudja_indokolni	ezeket
ezeket_indokolni_jelens	a
ezeket_geket_a	jelens
a_jelens_A	geket
geket_jelens_kor	A
geket_A_bban	kor
kor_kondicion_A	bban
kor_lt_bban	kondicion
kondicion_g_bban	lt
kondicion_lt_tl	g
g_megsz_lt	tl
g_n_tl	megsz
se_megsz_tl	n
szerkeszt_megsz_n	se
se_n_s	szerkeszt
se_szerkeszt_Az	s
s_szerkeszt_RW	Az
s_Az_modell	RW
bej_Az_RW	modell
modell_RW_solja	bej
bej_hogy_modell	solja
bej_az_solja	hogy
ism_hogy_solja	az
telt_hogy_az	ism
ism_bemutat_az	telt
ism_telt_sa	bemutat
bemutat_telt_a	sa
bemutat_kondicion_sa	a
sa_a_lt	kondicion
kondicion_g_a	lt
kondicion_lt_tl	g
g_nak_lt	tl
g_nmag_tl	nak
ban_nak_tl	nmag
nak_a_nmag	ban
ban_CS_nmag	a
ban_negat_a	CS
v_CS_a	negat
CS_negat_asszociat	v
v_negat	asszociat
v_er_asszociat	v
vel_v_asszociat	er
v_az_er	vel
vel_inger_er	az
vel_az_kihal	inger
inger_az_s	kihal
inger_t_kihal	s
s_eredm_kihal	t
s_t_nyezi	eredm
t_negat_eredm	nyezi
nyezi_v_eredm	negat
nyezi_negat_asszociat	v
v_negat	asszociat
v_rt_asszociat	v
v_k_asszociat	rt
cs_v_rt	k
k_rt_kkenn	cs
cs_se_k	kkenn
cs_kkenn_Ez	se
se_egy_kkenn	Ez
se_hamis_Ez	egy
j_egy_Ez	hamis
egy_hamis_slat	j
j_Ezzel_hamis	slat
j_szemben_slat	Ezzel
k_Ezzel_slat	szemben
szemben_Ezzel_s	k
szemben_k_rletek	s
s_k_azt	rletek
s_mutatj_rletek	azt
k_azt_rletek	mutatj
hogy_mutatj_azt	k
k_a_mutatj	hogy
kond_k_hogy	a
a_hogy_ci	kond
kond_nalt_a	ci
kond_ci_g	nalt
nalt_ci_tl	g
ism_g_nalt	tl
g_telt_tl	ism
ism_bemutat_tl	telt
ism_telt_sa	bemutat
bemutat_telt_n	sa
bemutat_sa_veli	n
g_sa_n	veli
tl_n_veli	g
hat_g_veli	tl
s_g_tl	hat
hat_t_tl	s
hat_jrapozicion_s	t
s_t_l	jrapozicion
s_t_jrapozicion	l
l_a_jrapozicion	s
l_kihal_s	a
s_a	kihal
ut_a_kihal	s
s_n_kihal	ut
s_szerkeszt_ut	n
s_ut_n	szerkeszt
szerkeszt_n_Az	s
s_szerkeszt_egyik	Az
s_Az_felt	egyik
egyik_Az_telez	felt
s_egyik_felt	telez
a_telez_felt	s
s_modellnek_telez	a
s_hogy_a	modellnek
modellnek_a	hogy
hogy_modellnek_CS	a
a_hogy_kondicion	CS
l_CS_a	kondicion
s_kondicion_CS	l
l_kondicion_nak	s
l_t_s	nak
s_nak_rt	t
nete_t_nak	rt
t_rt_nincs	nete
nete_rt_hat	nincs
nete_ssal_nincs	hat
hat_a_nincs	ssal
hat_ssal_jelenlegi	a
llapot_ssal_a	jelenlegi
jelenlegi_a_ra	llapot
llapot_csak_jelenlegi	ra
llapot_a_ra	csak
csak_jelenlegi_ra	a
csak_a_asszociat	jelenlegi
v_jelenlegi_a	asszociat
rt_jelenlegi_asszociat	v
v_ke_asszociat	rt
fontos_v_rt	ke
Ellenkez_rt_ke	fontos
fontos_leg_ke	Ellenkez
fontos_Ellenkez_sz	leg
Ellenkez_leg_mos	sz
k_leg_sz	mos
s_mos_sz	k
k_mos_rletek	s
s_k_azt	rletek
s_mutatj_rletek	azt
k_azt_rletek	mutatj
hogy_mutatj_azt	k
k_az_mutatj	hogy
k_hogy_ingerek	az
amelyek_hogy_az	ingerek
el_az_ingerek	amelyek
amelyek_sz_ingerek	el
el_r_amelyek	sz
el_kondicion_sz	r
r_sz_lva	kondicion
r_voltak_kondicion	lva
kondicion_majd_lva	voltak
voltak_kioltva_lva	majd
k_voltak_majd	kioltva
majd_nnyebben_kioltva	k
k_fel_kioltva	nnyebben
j_k_nnyebben	fel
that_fel_nnyebben	j
j_ak_fel	that
j_voltak_that	ak
ak_that_azaz	voltak
voltak_ak_kevesebb	azaz
kondicion_voltak_azaz	kevesebb
l_azaz_kevesebb	kondicion
kondicion_sra_kevesebb	l
l_kondicion_volt	sra
l_sra_sz	volt
sra_volt_ks	sz
g_volt_sz	ks
A_sz_ks	g
g_serkent_ks	A
s_g_A	serkent
s_serkent_A	s
s_a_serkent	s
s_g	a
s_a_tl	g
s_g_a	tl
kiz_g_tl	s
s_r_tl	kiz
s_lagoss_kiz	r
kiz_r_ga	lagoss
szerkeszt_r_lagoss	ga
s_ga_lagoss	szerkeszt
szerkeszt_Az_ga	s
s_szerkeszt_RW	Az
s_Az_modell	RW
Az_RW_felt	modell
telezi_modell_RW	felt
hogy_modell_felt	telezi
telezi_serkent_felt	hogy
s_telezi_hogy	serkent
serkent_hogy_s	s
s_a_serkent	s
s_g	a
s_a_tl	g
s_g_a	tl
ellenkez_g_tl	s
s_tulajdons_tl	ellenkez
s_ellenkez_g	tulajdons
ellenkez_tulajdons_Az	g
g_tulajdons_szt	Az
nz_g_Az	szt
Az_nek_szt	nz
nz_vagy_szt	nek
nz_serkent_nek	vagy
vagy_pozit_nek	serkent
vagy_v_serkent	pozit
serkent_pozit_asszociat	v
v_pozit	asszociat
v_ereje_asszociat	v
vagy_v_asszociat	ereje
g_v_ereje	vagy
vagy_ereje_tl	g
vagy_g_hat	tl
g_sa_tl	hat
hat_negat_tl	sa
hat_v_sa	negat
negat_sa_asszociat	v
v_negat	asszociat
v_ereje_asszociat	v
lehet_v_asszociat	ereje
v_de_ereje	lehet
lehet_mindkett_ereje	de
egyszerre_lehet_de	mindkett
nem_mindkett_de	egyszerre
mindkett_Ezzel_egyszerre	nem
nem_szemben_egyszerre	Ezzel
nem_n_Ezzel	szemben
szemben_Ezzel_ha	n
szemben_n_megfigyelhet	ha
n_hogy_ha	megfigyelhet
ingereknek_megfigyelhet_ha	hogy
k_hogy_megfigyelhet	ingereknek
ingereknek_hogy_tf	k
ingereknek_k_le	tf
tulajdons_k_tf	le
ga_le_tf	tulajdons
is_tulajdons_le	ga
lehet_tulajdons_ga	is
is_Ennek_ga	lehet
is_lehet_egyik	Ennek
lehet_p_Ennek	egyik
egyik_ld_Ennek	p
egyik_ja_p	ld
a_ld_p	ja
ja_h_ld	a
ja_a_tra	h
serkent_a_h	tra
kondicion_h_tra	serkent
l_serkent_tra	kondicion
s_kondicion_serkent	l
l_kondicion_amelyben	s
l_a_s	amelyben
s_CS_amelyben	a
a_amelyben_visszafel	CS
CS_a_p	visszafel
CS_ros_visszafel	p
tva_visszafel_p	ros
van_ros_p	tva
ros_az_tva	van
van_US_tva	az
el_van_az	US
US_az	el
el_CS_US	US
el_US_a	CS
CS_US	a
CS_US_a	CS
CS_helyett_a	US
CS_US_Ez	helyett
helyett_US_ltal	Ez
ban_helyett_Ez	ltal
CS_ltal_Ez	ban
ban_ltal_t	CS
ban_CS_kondicion	t
t_CS_lt	kondicion
t_serkent_kondicion	lt
kondicion_v_lt	serkent
teszi_serkent_lt	v
De_v_serkent	teszi
teszi_v_rdekes	De
teszi_De_m	rdekes
De_don_rdekes	m
az_m_rdekes	don
don_m_szt	az
nz_don_az	szt
az_nek_szt	nz
nz_g_szt	nek
nz_nek_tl	g
funkci_g_nek	tl
i_g_tl	funkci
is_funkci_tl	i
i_funkci_vannak	is
i_ami_is	vannak
is_bizony_vannak	ami
that_ami_vannak	bizony
bizony_a_ami	that
bizony_that_retard	a
a_that_ci	retard
retard_tesztj_a	ci
retard_vel_ci	tesztj
tesztj_Ez_ci	vel
vel_tesztj_a	Ez
vel_teszt_Ez	a
mutatja_a_Ez	teszt
teszt_a_az	mutatja
teszt_mutatja_szt	az
nz_mutatja_az	szt
g_az_szt	nz
nz_tl_szt	g
nz_g_hat	tl
s_g_tl	hat
hat_t_tl	s
hat_mivel_s	t
s_t_a	mivel
t_serkent_mivel	a
kondicion_a_mivel	serkent
serkent_l_a	kondicion
s_kondicion_serkent	l
l_kondicion_az	s
l_el_s	az
s_az_z	el
el_leg_az	z
el_kondicion_z	leg
leg_lt_z	kondicion
kondicion_g_leg	lt
kondicion_lt_tl	g
val_g_lt	tl
nem_g_tl	val
val_t_tl	nem
val_nem_k	t
nem_t_letes	k
t_k_A	letes
k_letes_visszafel	A
kondicion_letes_A	visszafel
lt_visszafel_A	kondicion
inger_kondicion_visszafel	lt
kondicion_tesztje_lt	inger
inger_lt_sikeres	tesztje
inger_tesztje_s	sikeres
gy_tesztje_sikeres	s
s_t_sikeres	gy
s_nik_gy	t
gy_t_hogy	nik
t_nik_mind	hogy
a_nik_hogy	mind
serkent_hogy_mind	a
s_a_mind	serkent
serkent_g_a	s
s_serkent_tl	g
s_funkci_g	tl
g_k_tl	funkci
funkci_tl_megvannak	k
j_funkci_k	megvannak
inger_megvannak_k	j
j_megvannak_p	inger
j_inger_ros	p
inger_t_p	ros
sa_ros_p	t
t_ros_a	sa
t_sa_kondicion	a
sa_a_lt	kondicion
kondicion_g_a	lt
kondicion_lt_tl	g
val_g_lt	tl
szerkeszt_g_tl	val
val_tl_s	szerkeszt
val_szerkeszt_A	s
s_szerkeszt_kondicion	A
s_lt_A	kondicion
kondicion_g_A	lt
kondicion_lt_tl	g
g_nak_lt	tl
g_tl_felt	nak
nak_tl_telezhet	felt
en_nak_felt	telezhet
telezhet_negat_felt	en
v_en_telezhet	negat
en_negat_asszociat	v
v_negat	asszociat
v_rt_asszociat	v
v_ke_asszociat	rt
v_rt_van	ke
rt_ke_Ha	van
j_van_ke	Ha
van_ingert_Ha	j
j_Ha_asszociat	ingert
j_v_ingert	asszociat
ingert_ereje_asszociat	v
nulla_v_asszociat	ereje
v_adunk_ereje	nulla
nulla_a_ereje	adunk
nulla_g_adunk	a
a_adunk_tl	g
g_a_hoz	tl
g_a_tl	hoz
hoz_modell_tl	a
hoz_a_azt	modell
j_a_modell	azt
solja_modell_azt	j
j_hogy_azt	solja
j_az_solja	hogy
j_hogy_solja	az
hogy_az_jelz	j
j_az_nek	jelz
j_kell_jelz	nek
nek_kondicion_jelz	kell
kell_lt_nek	kondicion
kell_serkent_kondicion	lt
kondicion_v_lt	serkent
v_serkent_lt	v
lnia_v_serkent	v
v_Nem	lnia
lnia_v_ez	Nem
lnia_Nem_a	ez
helyzet_Nem_ez	a
k_a_ez	helyzet
helyzet_a_s	k
helyzet_rleti_k	s
s_helyzetekben_k	rleti
s_rleti_A	helyzetekben
rleti_helyzetekben_modell	A
el_helyzetekben_A	modell
rejelz_modell_A	el
el_se_modell	rejelz
el_az_rejelz	se
se_rejelz_alap	az
se_fogalomb_az	alap
l_az_alap	fogalomb
lambda_fogalomb_alap	l
l_V_fogalomb	lambda
l_ered_lambda	V
lambda_V_Mivel	ered
V_ered_az	Mivel
sszes_ered_Mivel	az
Mivel_az_tett	sszes
sszes_az_asszociat	tett
v_sszes_tett	asszociat
ereje_tett_asszociat	v
v_az_asszociat	ereje
v_ereje_sszes	az
ingernek_az_ereje	sszes
sszes_az_V	ingernek
ingernek_sszes_ami	V
ingernek_jelen_V	ami
V_ami_van	jelen
jelen_ami_negativ	van
nulla_jelen_van	negativ
g_van_negativ	nulla
nulla_negativ_tl	g
nulla_g_hat	tl
g_sa_tl	hat
hat_tl_s	sa
hat_sa_a	s
s_sa_lambda	a
s_nulla_a	lambda
lambda_a_nincs	nulla
lambda_nulla_jelen	nincs
nulla_az_nincs	jelen
jelen_US_nincs	az
jelen_az	US
US_az_ebb	az
l_US_az	ebb
ered_az_ebb	l
l_v_ebb	ered
l_ered_ltoz	v
s_v_ered	ltoz
ltoz_v_asszociat	s
ltoz_v_s	asszociat
s_ereje_asszociat	v
v_pozit_asszociat	ereje
v_ereje	pozit
gy_pozit_ereje	v
v_az_pozit	gy
gy_v_j	az
gy_az_jelz	j
j_egy_az	jelz
j_kondicion_jelz	egy
lis_egy_jelz	kondicion
kondicion_egy_serkent	lis
kondicion_lis_CS	serkent
lis_preexposure_serkent	CS
hat_CS_serkent	preexposure
CS_preexposure_sa	hat
hat_l_preexposure	sa
hat_tens_sa	l
l_g_sa	tens
l_tens_tl	g
s_tens_g	tl
szerkeszt_g_tl	s
s_tl	szerkeszt
s_szerkeszt_A	s
s_szerkeszt_CS	A
s_preexposure_A	CS
hat_CS_A	preexposure
s_CS_preexposure	hat
hat_preexposure_m	s
hat_s	m
s_n_m	s
s_ven_m	n
s_l_n	ven
tens_n_ven	l
l_g_ven	tens
l_tens_tl	g
s_tens_g	tl
g_a_tl	s
s_j_tl	a
s_l_a	j
j_a_ismert	l
j_l_megfigyel	ismert
l_ismert_s	megfigyel
hogy_ismert_megfigyel	s
s_kondicion_megfigyel	hogy
s_l_hogy	kondicion
s_kondicion_hogy	l
l_kondicion_expoz	s
l_ci_s	expoz
s_expoz_ut	ci
expoz_n_ci	ut
az_ut_ci	n
inger_ut_n	az
k_n_az	inger
inger_az_s	k
inger_k_bb	s
s_k_mint	bb
s_CS_bb	mint
mint_felt_bb	CS
teles_CS_mint	felt
inger_CS_felt	teles
teles_nem_felt	inger
teles_t_inger	nem
inger_nem_k	t
nem_t_letes	k
t_k_Az	letes
k_letes_RW	Az
Az_letes_modell	RW
nem_Az_RW	modell
j_modell_RW	nem
nem_modell_sol	j
nem_j_semmilyen	sol
j_hat_sol	semmilyen
st_sol_semmilyen	hat
hat_j_semmilyen	st
hat_inger_st	j
j_st_US	inger
j_inger_n	US
inger_US_lk	n
li_US_n	lk
bemutat_n_lk	li
sakor_li_lk	bemutat
bemutat_li_Magasabb	sakor
bemutat_sakor_rend	Magasabb
sakor_kondicion_Magasabb	rend
l_rend_Magasabb	kondicion
s_kondicion_rend	l
l_kondicion_szerkeszt	s
l_s	szerkeszt
s_szerkeszt_A	s
s_szerkeszt_magasabb	A
s_rend_A	magasabb
kondicion_A_magasabb	rend
l_rend_magasabb	kondicion
s_kondicion_rend	l
l_kondicion_kor	s
l_bban_s	kor
s_kor_kondicion	bban
kor_lt_bban	kondicion
kondicion_CS_bban	lt
kondicion_lt_p	CS
CS_ros_lt	p
CS_tva_p	ros
van_ros_p	tva
egy_ros_tva	van
j_van_tva	egy
van_egy_jelz	j
j_vel_egy	jelz
j_azaz_jelz	vel
vel_az_jelz	azaz
vel_azaz_els	az
az_azaz_CS	els
US_az_els	CS
CS_majd_els	US
CS_US	majd
majd_CS_US	CS
CS_majd_ltal	CS
ban_CS	ltal
CS_ltal_az	ban
j_ban_ltal	az
ban_CS_az	j
j_hasonl_az	CS
j_CS_reakci	hasonl
hasonl_CS_kat	reakci
hasonl_v_reakci	kat
reakci_lt_kat	v
ki_v_kat	lt
v_mint_lt	ki
ki_a_lt	mint
ki_mint_CS	a
mint_a_A	CS
CS_a_modell	A
nem_CS_A	modell
tudja_modell_A	nem
nem_modell_indokoln	tudja
nem_i_tudja	indokoln
ezt_tudja_indokoln	i
i_a_indokoln	ezt
i_ezt_jelens	a
ezt_a_get	jelens
a_jelens_mivel	get
get_a_jelens	mivel
CS_mivel_get	a
CS_a_mivel	CS
CS_k_a	CS
s_CS	k
rletekn_CS_k	s
s_l_k	rletekn
s_rletekn_nincs	l
l_rletekn_az	nincs
l_US_nincs	az
jelen_az_nincs	US
De_US_az	jelen
jelen_US_az	De
De_jelen_ltal	az
De_hogy_az	ltal
a_ltal_az	hogy
hogy_ltal_CS	a
a_hasonl_hogy	CS
CS_k_a	hasonl
hasonl_CS_ppen	k
hasonl_k_viselkedik	ppen
mint_ppen_k	viselkedik
a_ppen_viselkedik	mint
mint_viselkedik_US	a
mint_a_ssze	US
lehet_US_a	ssze
egyeztetni_US_ssze	lehet
lehet_ssze_a	egyeztetni
lehet_modellt_egyeztetni	a
egyeztetni_ezzel_a	modellt
modellt_a	ezzel
hat_modellt_ezzel	a
ssal_ezzel_a	hat
hat_a_rz	ssal
hat_ssal_kszervi	rz
el_ssal_rz	kszervi
kondicion_kszervi_rz	el
el_l_kszervi	kondicion
el_kondicion_s	l
l_kondicion_szerkeszt	s
l_s	szerkeszt
s_szerkeszt_rz	s
s_szerkeszt_kszervi	rz
s_rz_el	kszervi
kondicion_kszervi_rz	el
el_l_kszervi	kondicion
el_kondicion_s	l
l_kondicion_utal	s
l_az_s	utal
s_utal_els	az
utal_az_p	els
ros_az_els	p
t_els_p	ros
s_ros_p	t
t_k_ros	s
s_t	k
s_j_k	t
t_k_jelz	j
j_t	jelz
j_re_jelz	j
j_CS_jelz	re
j_CS_re	CS
re_CS_majd	CS
egyik_CS	majd
k_CS_majd	egyik
egyik_majd_p	k
egyik_k_ros	p
t_k_p	ros
sa_ros_p	t
t_ros_az	sa
USel_t_sa	az
CS_sa_az	USel
USel_US_az	CS
USel_CS_Ez	US
CS_US_a	Ez
CS_US_Ez	a
s_a_Ez	CS
CS_a	s
s_t_CS	CS
s_kondicion_CS	t
t_CS_lt	kondicion
t_serkent_kondicion	lt
kondicion_v_lt	serkent
v_serkent_lt	v
ltoztatja_v_serkent	v
v_Az	ltoztatja
v_ltoztatja_RW	Az
ltoztatja_modell_Az	RW
nem_Az_RW	modell
tudja_modell_RW	nem
nem_megmagyar_modell	tudja
nem_tudja_zni	megmagyar
megmagyar_tudja_ezt	zni
megmagyar_zni_mert	ezt
ezt_zni_a	mert
ezt_CS_mert	a
CS_a_mert	CS
CS_f_a	CS
zis_CS	f
k_CS_f	zis
zis_f_z	k
zis_k_tt	z
mindk_k_z	tt
t_tt_z	mindk
ingernek_tt_mindk	t
t_az_mindk	ingernek
ingernek_t_asszociat	az
ingernek_v_az	asszociat
rt_az_asszociat	v
v_ke_asszociat	rt
nulla_v_rt	ke
s_rt_ke	nulla
nulla_a_ke	s
nulla_lambda_s	a
s_a_is	lambda
lambda_nulla_a	is
lambda_nincs_is	nulla
is_nulla_jelen	nincs
nulla_US_nincs	jelen
jelen_amely_nincs	US
nem_jelen_US	amely
amely_US_eredm	nem
nem_amely_nyez	eredm
nem_v_eredm	nyez
nyez_eredm_ltoz	v
nyez_v_st	ltoz
ltoz_v_az	st
ltoz_inger_st	az
st_az_asszociat	inger
inger_v_az	asszociat
inger_erej_asszociat	v
v_ben_asszociat	erej
v_erej_Hivatkoz	ben
ben_erej_sok	Hivatkoz
szerkeszt_ben_Hivatkoz	sok
s_Hivatkoz_sok	szerkeszt
szerkeszt_a_sok	s
s_szerkeszt_b	a
s_a_Miller	b
b_Ralph_a	Miller
R_b_Miller	Ralph
Barnet_Ralph_Miller	R
Robert_Ralph_R	Barnet
C_Barnet_R	Robert
Barnet_Robert_Grahame	C
C_Robert_Nicholas	Grahame
C_J_Grahame	Nicholas
Nicholas_Rescorla_Grahame	J
Wagner_Nicholas_J	Rescorla
model_Rescorla_J	Wagner
Wagner_Rescorla_rt	model
Wagner_model_kel	rt
se_model_rt	kel
Psychological_rt_kel	se
se_Bulletin_kel	Psychological
se_Psychological_Amerikai	Bulletin
Psychological_Bulletin_Pszichol	Amerikai
Bulletin_giai_Amerikai	Pszichol
Pszichol_T_Amerikai	giai
rsas_Pszichol_giai	T
g_giai_T	rsas
rsas_doi_T	g
PMID_rsas_g	doi
g_doi_Van	PMID
PMID_doi_Hamme	Van
PMID_LJ_Van	Hamme
s_Van_Hamme	LJ
Wasserman_LJ_Hamme	s
s_E_LJ	Wasserman
s_Wasserman_A	E
Wasserman_Cue_E	A
E_competition_A	Cue
in_Cue_A	competition
Cue_competition_causality	in
competition_in_judgements	causality
The_in_causality	judgements
role_causality_judgements	The
of_The_judgements	role
role_The_nonpresentation	of
role_of	nonpresentation
nonpresentation_compound_of	of
stimulus_nonpresentation_of	compound
elements_compound_of	stimulus
stimulus_compound_Tanul	elements
s_stimulus_elements	Tanul
s_elements_Tanul	s
s_motiv_Tanul	s
s_ci	motiv
s_motiv_Rescorla	ci
motiv_ci_R	Rescorla
Rescorla_ci_A	R
s_Rescorla_R	A
A_Wagner_R	s
s_A	Wagner
s_Wagner_R	A
Wagner_A	R
R_pavlovi_A	A
A_kondicion_R	pavlovi
l_pavlovi_A	kondicion
s_kondicion_pavlovi	l
l_kondicion_te	s
l_ri_s	te
s_ja_te	ri
ri_te_Vari	ja
ri_ja_ci	Vari
ja_k_Vari	ci
ci_a_Vari	k
hat_k_ci	a
k_a_konys	hat
hat_g_a	konys
hat_s_konys	g
hat_g_konys	s
s_konytalans_g	hat
s_g_hat	konytalans
hat_konytalans	g
s_konytalans_g	hat
hat_r_g	s
hat_l_s	r
s_r_Klasszikus	l
l_r_kondicion	Klasszikus
l_Klasszikus	kondicion
s_kondicion_Klasszikus	l
l_kondicion_II	s
l_A_s	II
s_H_II	A
Black_A_II	H
s_H_A	Black
Black_H_W	s
s_Black_F	W
s_Prokasy_W	F
F_Szerk_W	Prokasy
F_Prokasy_Pp	Szerk
Appleton_Prokasy_Szerk	Pp
Century_Szerk_Pp	Appleton
Crofts_Appleton_Pp	Century
Century_Appleton_K	Crofts
Century_ls_Crofts	K
K_Crofts_hivatkoz	ls
K_ls_sok	hivatkoz
szerkeszt_ls_hivatkoz	sok
s_sok_hivatkoz	szerkeszt
Scholarpedia_szerkeszt_sok	s
s_szerkeszt_Rescorla	Scholarpedia
s_Scholarpedia_Wagner	Rescorla
Scholarpedia_Rescorla_modell	Wagner
Wagner_Rescorla_Forr	modell
Wagner_modell_sok	Forr
szerkeszt_modell_Forr	sok
s_sok_Forr	szerkeszt
Ugr_szerkeszt_sok	s
s_szerkeszt	Ugr
s_Ugr_fel	s
s_Miller_Ugr	fel
s_Ralph_fel	Miller
R_Miller_fel	Ralph
Barnet_Ralph_Miller	R
Robert_Ralph_R	Barnet
C_Barnet_R	Robert
Barnet_Robert_Grahame	C
C_Robert_Nicholas	Grahame
C_J_Grahame	Nicholas
Nicholas_Assessment_Grahame	J
Nicholas_J_of	Assessment
the_J_Assessment	of
Rescorla_Assessment_of	the
Wagner_the_of	Rescorla
Model_the_Rescorla	Wagner
Wagner_Psychological_Rescorla	Model
Wagner_Model_Bulletin	Psychological
Psychological_Model_American	Bulletin
Psychological_Bulletin	American
American_Bulletin_Association	Psychological
Psychological_American_doi	Association
Psychological_PMID_Association	doi
doi_Association_Ugr	PMID
s_PMID_doi	Ugr
PMID_Ugr_fel	s
s_Van_Ugr	fel
s_Hamme_fel	Van
Van_L_fel	Hamme
Van_Hamme_J	L
Wasserman_Hamme_L	J
E_J_L	Wasserman
Wasserman_J_A	E
Wasserman_Cue_E	A
E_competition_A	Cue
in_Cue_A	competition
Cue_competition_causality	in
competition_in_judgements	causality
The_in_causality	judgements
role_causality_judgements	The
of_The_judgements	role
role_The_nonpresentation	of
role_of	nonpresentation
nonpresentation_compound_of	of
stimulus_nonpresentation_of	compound
elements_compound_of	stimulus
stimulus_compound_Learning	elements
stimulus_elements_and	Learning
Learning_Motivation_elements	and
Learning_and_A	Motivation
Motivation_and_lap	A
Motivation_eredeti_A	lap
c_A_lap	eredeti
me_eredeti_lap	c
c_https_eredeti	me
hu_c_me	https
wikipedia_https_me	hu
https_hu_org	wikipedia
w_wikipedia_hu	org
wikipedia_index_org	w
w_php_org	index
w_index_title	php
index_Rescorla_php	title
Wagner_title_php	Rescorla
Rescorla_title_modell	Wagner
Wagner_Rescorla_oldid	modell
Wagner_modell_Kateg	oldid
ria_oldid_modell	Kateg
Biol_oldid_Kateg	ria
ria_gia_Kateg	Biol
ria_Biol_Rejtett	gia
kateg_Biol_gia	Rejtett
ri_Rejtett_gia	kateg
kateg_k_Rejtett	ri
ri_kateg_Pages	k
ri_k_using	Pages
Pages_PMID_k	using
Pages_magic_using	PMID
PMID_using_links	magic
PMID_magic_Korrekt	links
r_magic_links	Korrekt
links_Korrekt_zand	r
r_lapok_Korrekt	zand
r_Navig_zand	lapok
lapok_ci_zand	Navig
s_Navig_lapok	ci
men_Navig_ci	s
s_ci_Szem	men
s_men_lyes	Szem
eszk_men_Szem	lyes
lyes_z_Szem	eszk
eszk_k_lyes	z
eszk_Nem_z	k
vagy_k_z	Nem
Nem_k_bejelentkezve	vagy
vagy_Nem_Vitalap	bejelentkezve
vagy_bejelentkezve_K	Vitalap
zrem_Vitalap_bejelentkezve	K
k_Vitalap_K	zrem
zrem_K_d	k
zrem_k_sek	d
k_d_Fi	sek
k_sek_d	Fi
l_sek_Fi	k
trehoz_k_Fi	l
l_k_sa	trehoz
l_trehoz_Bejelentkez	sa
s_trehoz_sa	Bejelentkez
N_sa_Bejelentkez	s
s_vterek_Bejelentkez	N
s_N_Sz	vterek
N_vterek_cikk	Sz
Vitalap_vterek_Sz	cikk
V_cikk_Sz	Vitalap
Vitalap_ltozatok_cikk	V
V_N_Vitalap	ltozatok
V_ltozatok_zetek	N
N_ltozatok_Olvas	zetek
s_zetek_N	Olvas
Szerkeszt_zetek_Olvas	s
s_Olvas	Szerkeszt
s_Szerkeszt_Lapt	s
s_Szerkeszt_rt	Lapt
s_net_Lapt	rt
Lapt_rt_T	net
net_rt_bb	T
net_T_Keres	bb
s_T_bb	Keres
Keres_Navig_bb	s
s_ci_Keres	Navig
s_Kezd_Navig	ci
Navig_ci_lap	Kezd
Kezd_Tartalom_ci	lap
Kezd_Kiemelt_lap	Tartalom
Tartalom_sz_lap	Kiemelt
Tartalom_Kiemelt_cikkek	sz
Friss_Kiemelt_sz	cikkek
v_sz_cikkek	Friss
Friss_ltoztat_cikkek	v
Friss_v_sok	ltoztat
v_Lap_ltoztat	sok
ltoztat_tal_sok	Lap
lomra_Lap_sok	tal
Lap_Tudakoz_tal	lomra
lomra_tal_R	Tudakoz
lomra_Tudakoz_szv	R
tel_Tudakoz_R	szv
Kezd_R_szv	tel
knek_tel_szv	Kezd
Kezd_tel_Seg	knek
Kezd_knek_ts	Seg
g_knek_Seg	ts
ts_Seg_K	g
z_g_ts	K
g_ss_K	z
gi_K_z	ss
ss_port_z	gi
l_gi_ss	port
gi_port_Kapcsolatfelv	l
l_tel_port	Kapcsolatfelv
l_Adom_Kapcsolatfelv	tel
tel_Kapcsolatfelv_nyok	Adom
tel_Adom_Nyomtat	nyok
s_nyok_Adom	Nyomtat
nyok_export_Nyomtat	s
s_l_Nyomtat	export
s_export	l
l_K_export	s
l_nyv_s	K
s_k_K	nyv
nyv_K_sz	k
nyv_k_t	sz
se_k_sz	t
t_Let_sz	se
se_t_lt	Let
se_Let_s	lt
PDF_lt_Let	s
s_k_lt	PDF
s_nt_PDF	k
PDF_k_Eszk	nt
nt_k_z	Eszk
nt_k_Eszk	z
Mi_Eszk_z	k
k_hivatkozik_z	Mi
k_Mi_erre	hivatkozik
Kapcsol_Mi_hivatkozik	erre
d_erre_hivatkozik	Kapcsol
v_Kapcsol_erre	d
ltoztat_Kapcsol_d	v
v_d_sok	ltoztat
v_ltoztat_Speci	sok
lis_ltoztat_sok	Speci
lapok_Speci_sok	lis
lis_Hivatkoz_Speci	lapok
s_lis_lapok	Hivatkoz
lapok_Hivatkoz_erre	s
s_a_Hivatkoz	erre
s_v_erre	a
a_erre_ltozatra	v
v_a_Lapinform	ltozatra
ci_v_ltozatra	Lapinform
k_Lapinform_ltozatra	ci
Lapinform_ci_Wikidata	k
adatlap_k_ci	Wikidata
k_Wikidata_Hogyan	adatlap
adatlap_Wikidata_hivatkozz	Hogyan
adatlap_erre_Hogyan	hivatkozz
hivatkozz_a_Hogyan	erre
lapra_erre_hivatkozz	a
M_a_erre	lapra
s_lapra_a	M
M_lapra_nyelveken	s
M_English_s	nyelveken
s_nyelveken_Deutsch	English
Fran_nyelveken_English	Deutsch
ais_English_Deutsch	Fran
Fran_Nederlands_Deutsch	ais
ais_Fran_Linkek	Nederlands
szerkeszt_ais_Nederlands	Linkek
se_Nederlands_Linkek	szerkeszt
A_szerkeszt_Linkek	se
se_szerkeszt_lap	A
se_utols_A	lap
m_A_lap	utols
utols_dos_lap	m
utols_t_m	dos
sa_dos_m	t
t_dos_okt	sa
t_ber_sa	okt
A_sa_okt	ber
ber_okt_lap	A
ber_sz_A	lap
vege_A_lap	sz
Creative_sz_lap	vege
Commons_vege_sz	Creative
Creative_vege_Nevezd	Commons
Creative_Commons_meg	Nevezd
gy_Commons_Nevezd	meg
meg_add_Nevezd	gy
gy_tov_meg	add
gy_add_bb	tov
tov_add_licenc	bb
tov_alatt_bb	licenc
van_licenc_bb	alatt
egyes_alatt_licenc	van
esetekben_van_alatt	egyes
egyes_van_m	esetekben
s_egyes_esetekben	m
esetekben_m	s
s_don_m	m
s_m_is	don
don_felhaszn_m	is
is_don_lhat	felhaszn
is_felhaszn_R	lhat
felhaszn_lhat_szletek	R
lhat_rt_R	szletek
l_szletek_R	rt
sd_rt_szletek	l
l_rt_a	sd
l_felhaszn_sd	a
l_sd_a	felhaszn
felhaszn_a_si	l
l_felhaszn_felt	si
l_teleket_si	felt
nbsp_felt_si	teleket
teleket_Adatv_felt	nbsp
nbsp_delmi_teleket	Adatv
ir_nbsp_Adatv	delmi
nyelvek_delmi_Adatv	ir
ir_delmi_A	nyelvek
nyelvek_ir_Wikip	A
nyelvek_di_A	Wikip
r_Wikip_A	di
di_l_Wikip	r
di_r_Jogi	l
l_r_nyilatkozat	Jogi
l_Fejleszt_Jogi	nyilatkozat
k_Jogi_nyilatkozat	Fejleszt
S_Fejleszt_nyilatkozat	k
tinyilatkozat_k_Fejleszt	S
Mobil_S_k	tinyilatkozat
S_tinyilatkozat_n	Mobil
Mobil_tinyilatkozat_zet	n
nbsp_Mobil_n	zet
Wikimedia_n_zet	nbsp
Foundation_nbsp_zet	Wikimedia
Powered_Wikimedia_nbsp	Foundation
Foundation_Wikimedia_by	Powered
Foundation_Powered_MediaWiki	by
Powered_M_by	MediaWiki
by_gse_MediaWiki	M
M_Szerkeszt_MediaWiki	gse
M_s_gse	Szerkeszt
Szerkeszt_T_gse	s
s_Szerkeszt_rl	T
s_T	rl
El_T_rl	s
s_n_rl	El
s_El_zet	n
Vissza_El_n	zet
n_ll_zet	Vissza
t_Vissza_zet	ll
s_Vissza_ll	t
A_t_ll	s
s_t_jegyzet	A
s_sz_A	jegyzet
jegyzet_vege_A	sz
jegyzet_tartalmazhat_sz	vege
vege_wikik_sz	tartalmazhat
dot_tartalmazhat_vege	wikik
Nem_wikik_tartalmazhat	dot
siker_dot_wikik	Nem
lt_dot_Nem	siker
elmenti_Nem_siker	lt
lt_a_siker	elmenti
elmenti_jegyzetedet_lt	a
tal_a_elmenti	jegyzetedet
jegyzetedet_n_a	tal
szerkeszt_jegyzetedet_tal	n
tal_n_si	szerkeszt
szerkeszt_n_tk	si
szerkeszt_z_si	tk
s_tk_si	z
tk_z_miatt	s
s_M_z	miatt
s_sold_miatt	M
M_ki_miatt	sold
M_a_sold	ki
ki_sz_sold	a
ki_a_veget	sz
a_az_sz	veget
al_veget_sz	az
bbi_az_veget	al
szerkeszt_al_az	bbi
bbi_ablakb_al	szerkeszt
szerkeszt_bbi_l	ablakb
s_szerkeszt_ablakb	l
l_ablakb_k	s
l_zi_s	k
s_szerkeszt_k	zi
ssel_zi_k	szerkeszt
szerkeszt_zi_illeszd	ssel
be_szerkeszt_ssel	illeszd
ssel_illeszd_az	be
be_illeszd_oldalra	az
be_az_A	oldalra
jegyzet_az_oldalra	A
a_A_oldalra	jegyzet
jegyzet_CC_A	a
jegyzet_a_BY	CC
SA_CC_a	BY
CC_valamint_BY	SA
SA_a_BY	valamint
GFDL_SA_valamint	a
vagy_a_valamint	GFDL
GFDL_k_a	vagy
GFDL_s_vagy	k
vagy_bbi_k	s
s_v_k	bbi
s_bbi_ltozata	v
bbi_v_alatt	ltozata
ltozata_v_lesz	alatt
ltozata_alatt_k	lesz
zz_lesz_alatt	k
t_lesz_k	zz
zz_k_ve	t
zz_Tov_t	ve
t_ve_bbi	Tov
r_ve_Tov	bbi
bbi_Tov_szletek	r
bbi_rt_r	szletek
l_r_szletek	rt
sd_rt_szletek	l
l_rt_a	sd
l_felhaszn_sd	a
l_sd_a	felhaszn
felhaszn_a_si	l
l_felhaszn_felt	si
l_teleinket_si	felt
j_felt_si	teleinket
teleinket_k_felt	j
j_teleinket_pjegyzet	k
j_Jel_k	pjegyzet
lj_k_pjegyzet	Jel
ki_Jel_pjegyzet	lj
lj_Jel_egy	ki
lj_ki_t	egy
ki_egy_glalapot	t
t_egy_a	glalapot
fenti_t_glalapot	a
k_a_glalapot	fenti
fenti_a_pen	k
fenti_k_a	pen
bal_k_pen	a
eg_a_pen	bal
bal_a_rgomb	eg
eg_bal_nyomvatart	rgomb
s_eg_rgomb	nyomvatart
val_nyomvatart_rgomb	s
s_Ehhez_nyomvatart	val
s_a_val	Ehhez
val_k_Ehhez	a
Ehhez_a_phez	k
k_a_jegyzetek	phez
tartoznak_k_phez	jegyzetek
H_jegyzetek_phez	tartoznak
tartoznak_zd_jegyzetek	H
tartoznak_H_az	zd
egeret_zd_H	az
zd_a_az	egeret
egeret_k_az	a
egeret_a_p	k
k_a_f	p
l_k_p	f
f_a_p	l
l_f_megjelen	a
l_t_a	megjelen
s_a_megjelen	t
t_kh_megjelen	s
s_t_z	kh
s_kh_A	z
jegyzetet_kh_z	A
A_a_z	jegyzetet
z_jegyzetet_A	a
X_jegyzetet_a	z
oldalon_a_z	X
X_tudod_z	oldalon
X_oldalon_szerkeszteni	tudod
oldalon_Mi_tudod	szerkeszteni
szerkeszteni_rt_tudod	Mi
szerkeszteni_Mi_szeretn	rt
rt_Mi_d	szeretn
t_rt_szeretn	d
r_d_szeretn	t
t_lni_d	r
t_r_a	lni
r_jegyzetet_lni	a
Ment_a_lni	jegyzetet
s_jegyzetet_a	Ment
Ment_jegyzetet_Seg	s
s_Ment_ts	Seg
s_g_Seg	ts
a_ts_Seg	g
g_k_ts	a
g_a_pjegyzet	k
haszn_k_a	pjegyzet
k_lat_pjegyzet	haszn
haszn_hoz_pjegyzet	lat
haszn_lat_A	hoz
hoz_f_lat	A
jlhoz_hoz_A	f
k_f_A	jlhoz
jlhoz_f_pjegyzet	k
jlhoz_k_tartozik	pjegyzet
k_Gtk_pjegyzet	tartozik
dialog_tartozik_pjegyzet	Gtk
info_tartozik_Gtk	dialog
svg_Gtk_dialog	info
info_dialog_K	svg
svg_info_pjegyzet	K
svg_m_K	pjegyzet
K_dos_pjegyzet	m
t_m_pjegyzet	dos
s_dos_m	t
t_hoz_dos	s
s_t_olyan	hoz
s_hoz_b	olyan
hoz_ng_olyan	b
sz_b_olyan	ng
ng_re_b	sz
van_ng_sz	re
re_sz	van
re_van_ks	sz
g_van_sz	ks
ami_sz_ks	g
t_g_ks	ami
mogatja_g_ami	t
t_ami_a	mogatja
mogatja_t_XMLHttpRequest	a
mogatja_objektumot_a	XMLHttpRequest
a_XMLHttpRequest_A	objektumot
objektumot_te_XMLHttpRequest	A
objektumot_b_A	te
ng_te_A	b
b_te_sz	ng
ng_b_d	sz
nem_ng_sz	d
t_d_sz	nem
nem_mogatja_d	t
nem_t_ezt	mogatja
mogatja_t_az	ezt
mogatja_ezt_objektumot	az
vagy_ezt_az	objektumot
nincs_objektumot_az	vagy
vagy_objektumot_enged	nincs
vagy_lyezve_nincs	enged
a_enged_nincs	lyezve
haszn_lyezve_enged	a
lyezve_a_lata	haszn
haszn_Internet_a	lata
haszn_Explorerben_lata	Internet
el_Internet_lata	Explorerben
Explorerben_Internet_fordulhat	el
el_Explorerben_hogy	fordulhat
el_az_fordulhat	hogy
ActiveX_hogy_fordulhat	az
hogy_az_komponens	ActiveX
ActiveX_ki_az	komponens
ActiveX_van_komponens	ki
ki_komponens_kapcsolva	van
gy_ki_van	kapcsolva
nem_van_kapcsolva	gy
gy_kapcsolva_tudod	nem
gy_nem_m	tudod
nem_tudod_dos	m
tudod_m_tani	dos
a_dos_m	tani
k_dos_tani	a
a_pannot_tani	k
k_a_ci	pannot
t_k_pannot	ci
Eln_ci_pannot	t
t_ci_z	Eln
Eln_t_st	z
Eln_a_z	st
kellemetlens_st_z	a
g_st_a	kellemetlens
kellemetlens_rt_a	g
kellemetlens_g_Wikip	rt
dia_g_rt	Wikip
Wikip_rt_K	dia
dia_Wikip_pjegyzet	K
dia_K	pjegyzet
K_pjegyzet	K
hozz_K_pjegyzet	pjegyzet
K_ad_pjegyzet	hozz
sa_hozz_pjegyzet	ad
Wikip_ad_hozz	sa
dia_sa_ad	Wikip
Wikip_sa_K	dia
dia_Wikip_pjegyzet	K
dia_K	pjegyzet
K_pjegyzet	K
K_m_pjegyzet	pjegyzet
K_dos_pjegyzet	m
t_m_pjegyzet	dos
sa_dos_m	t
t_Wikip_dos	sa
t_sa_dia	Wikip
Wikip_sa_K	dia
dia_Wikip_pjegyzet	K
dia_K	pjegyzet
K_pjegyzet	K
t_K_pjegyzet	pjegyzet
rl_K_pjegyzet	t
se_t_pjegyzet	rl
t_rl	se
